,5 Minutes,Lane 1 Flow (Veh/5 Minutes),Lane 1 Speed (mph),Lane 2 Flow (Veh/5 Minutes),Lane 2 Speed (mph),Flow (Veh/5 Minutes),Speed (mph),# Lane Points,% Observed
0,2019-05-10 00:00:00,1,70.7,5,62.2,6,63.6,2,0
1,2019-05-10 00:05:00,8,70.7,9,62.4,17,66.3,2,0
2,2019-05-10 00:10:00,7,70.6,8,62.0,15,66.0,2,0
3,2019-05-10 00:15:00,1,70.6,5,62.0,6,63.4,2,0
4,2019-05-10 00:20:00,1,70.7,5,62.3,6,63.7,2,0
5,2019-05-10 00:25:00,1,70.6,5,62.0,6,63.4,2,0
6,2019-05-10 00:30:00,2,70.6,5,61.7,7,64.2,2,0
7,2019-05-10 00:35:00,3,70.5,6,61.6,9,64.6,2,0
8,2019-05-10 00:40:00,12,65.1,2,61.7,14,64.6,2,0
9,2019-05-10 00:45:00,3,70.6,6,61.7,9,64.7,2,0
10,2019-05-10 00:50:00,3,70.5,6,61.4,9,64.5,2,0
11,2019-05-10 00:55:00,14,65.2,4,61.8,18,64.4,2,0
12,2019-05-10 01:00:00,13,65.9,3,62.1,16,65.2,2,0
13,2019-05-10 01:05:00,14,65.4,4,61.9,18,64.6,2,0
14,2019-05-10 01:10:00,3,70.6,6,61.8,9,64.7,2,0
15,2019-05-10 01:15:00,3,70.7,6,62.2,9,65.0,2,0
16,2019-05-10 01:20:00,2,70.7,5,62.4,7,64.8,2,0
17,2019-05-10 01:25:00,12,65.8,2,62.1,14,65.3,2,0
18,2019-05-10 01:30:00,13,66.1,3,62.2,16,65.4,2,0
19,2019-05-10 01:35:00,13,65.4,3,61.9,16,64.8,2,0
20,2019-05-10 01:40:00,14,65.5,4,61.9,18,64.7,2,0
21,2019-05-10 01:45:00,2,70.7,5,62.3,7,64.7,2,0
22,2019-05-10 01:50:00,5,70.3,8,60.1,13,64.0,2,0
23,2019-05-10 01:55:00,14,62.9,4,60.8,18,62.5,2,0
24,2019-05-10 02:00:00,14,63.5,4,61.0,18,63.0,2,0
25,2019-05-10 02:05:00,13,64.9,3,61.6,16,64.2,2,0
26,2019-05-10 02:10:00,11,65.4,1,61.8,12,65.1,2,0
27,2019-05-10 02:15:00,12,65.1,2,61.7,14,64.7,2,0
28,2019-05-10 02:20:00,13,66.1,3,62.2,16,65.4,2,0
29,2019-05-10 02:25:00,13,66.3,3,62.3,16,65.6,2,0
30,2019-05-10 02:30:00,13,66.1,3,62.2,16,65.4,2,0
31,2019-05-10 02:35:00,14,65.9,4,62.1,18,65.1,2,0
32,2019-05-10 02:40:00,1,70.6,5,62.0,6,63.4,2,0
33,2019-05-10 02:45:00,11,65.8,1,62.1,12,65.5,2,0
34,2019-05-10 02:50:00,13,65.8,3,62.0,16,65.1,2,0
35,2019-05-10 02:55:00,11,65.8,1,62.0,12,65.5,2,0
36,2019-05-10 03:00:00,10,66.2,1,62.2,11,65.8,2,0
37,2019-05-10 03:05:00,11,66.5,1,62.4,12,66.1,2,0
38,2019-05-10 03:10:00,13,66.6,3,62.4,16,65.8,2,0
39,2019-05-10 03:15:00,7,70.7,8,62.3,15,66.2,2,0
40,2019-05-10 03:20:00,3,70.6,6,62.1,9,65.0,2,0
41,2019-05-10 03:25:00,11,65.9,1,62.1,12,65.6,2,0
42,2019-05-10 03:30:00,12,66.5,2,62.4,14,65.9,2,0
43,2019-05-10 03:35:00,2,70.7,5,62.3,7,64.7,2,0
44,2019-05-10 03:40:00,2,70.6,5,61.9,7,64.4,2,0
45,2019-05-10 03:45:00,2,70.6,5,62.0,7,64.5,2,0
46,2019-05-10 03:50:00,3,70.6,6,62.0,9,64.9,2,0
47,2019-05-10 03:55:00,14,65.8,4,62.0,18,64.9,2,0
48,2019-05-10 04:00:00,14,64.8,4,61.6,18,64.1,2,0
49,2019-05-10 04:05:00,12,65.4,2,61.8,14,64.9,2,0
50,2019-05-10 04:10:00,13,66.1,3,62.2,16,65.3,2,0
51,2019-05-10 04:15:00,5,70.7,8,62.2,13,65.4,2,0
52,2019-05-10 04:20:00,13,65.6,3,62.0,16,64.9,2,0
53,2019-05-10 04:25:00,2,70.7,5,62.3,7,64.7,2,0
54,2019-05-10 04:30:00,9,70.7,10,62.5,19,66.4,2,0
55,2019-05-10 04:35:00,3,70.7,6,62.4,9,65.2,2,0
56,2019-05-10 04:40:00,2,70.7,5,62.5,7,64.9,2,0
57,2019-05-10 04:45:00,12,70.7,12,62.7,24,66.7,2,0
58,2019-05-10 04:50:00,3,70.7,6,62.4,9,65.2,2,0
59,2019-05-10 04:55:00,12,70.8,12,62.9,24,66.8,2,0
60,2019-05-10 05:00:00,8,70.7,9,62.5,17,66.3,2,0
61,2019-05-10 05:05:00,10,70.7,10,62.2,20,66.4,2,0
62,2019-05-10 05:10:00,13,70.7,13,62.4,26,66.6,2,0
63,2019-05-10 05:15:00,10,70.7,10,62.4,20,66.5,2,0
64,2019-05-10 05:20:00,11,70.6,11,62.1,22,66.3,2,0
65,2019-05-10 05:25:00,20,70.7,17,62.3,37,66.8,2,0
66,2019-05-10 05:30:00,9,70.6,10,62.1,19,66.1,2,0
67,2019-05-10 05:35:00,25,70.6,20,62.0,45,66.8,2,0
68,2019-05-10 05:40:00,27,70.8,21,63.0,48,67.4,2,0
69,2019-05-10 05:45:00,25,70.9,20,63.5,45,67.6,2,0
70,2019-05-10 05:50:00,25,70.9,20,63.4,45,67.5,2,0
71,2019-05-10 05:55:00,22,70.8,18,62.9,40,67.2,2,0
72,2019-05-10 06:00:00,26,70.8,20,62.9,46,67.4,2,0
73,2019-05-10 06:05:00,17,70.7,15,62.4,32,66.8,2,0
74,2019-05-10 06:10:00,28,70.7,22,62.7,50,67.2,2,0
75,2019-05-10 06:15:00,34,70.5,25,61.3,59,66.6,2,0
76,2019-05-10 06:20:00,39,70.6,29,61.6,68,66.7,2,0
77,2019-05-10 06:25:00,36,70.9,27,63.7,63,67.8,2,0
78,2019-05-10 06:30:00,32,70.7,25,62.7,57,67.2,2,0
79,2019-05-10 06:35:00,34,70.6,25,61.6,59,66.8,2,0
80,2019-05-10 06:40:00,45,70.5,32,61.1,77,66.6,2,0
81,2019-05-10 06:45:00,52,70.8,37,63.1,89,67.6,2,0
82,2019-05-10 06:50:00,63,70.7,44,62.3,107,67.2,2,0
83,2019-05-10 06:55:00,52,70.7,37,62.6,89,67.4,2,0
84,2019-05-10 07:00:00,44,70.2,32,59.8,76,65.8,2,0
85,2019-05-10 07:05:00,50,70.1,36,58.8,86,65.4,2,0
86,2019-05-10 07:10:00,44,69.9,32,57.8,76,64.8,2,0
87,2019-05-10 07:15:00,54,69.9,38,58.0,92,65.0,2,0
88,2019-05-10 07:20:00,64,70.1,44,58.9,108,65.5,2,0
89,2019-05-10 07:25:00,79,69.9,54,57.9,133,65.1,2,0
90,2019-05-10 07:30:00,71,70.2,49,59.4,120,65.8,2,0
91,2019-05-10 07:35:00,66,70.2,46,59.3,112,65.7,2,0
92,2019-05-10 07:40:00,57,70.2,40,59.7,97,65.9,2,0
93,2019-05-10 07:45:00,68,70.1,47,58.8,115,65.5,2,0
94,2019-05-10 07:50:00,74,70.1,51,58.6,125,65.4,2,0
95,2019-05-10 07:55:00,75,70.1,51,58.7,126,65.5,2,0
96,2019-05-10 08:00:00,66,70.2,46,59.4,112,65.8,2,0
97,2019-05-10 08:05:00,76,70.0,52,58.1,128,65.1,2,0
98,2019-05-10 08:10:00,53,70.1,37,58.7,90,65.4,2,0
99,2019-05-10 08:15:00,52,70.1,37,59.0,89,65.5,2,0
100,2019-05-10 08:20:00,67,70.0,46,58.4,113,65.3,2,0
101,2019-05-10 08:25:00,63,70.1,44,58.6,107,65.4,2,0
102,2019-05-10 08:30:00,63,70.1,44,59.2,107,65.6,2,0
103,2019-05-10 08:35:00,66,70.1,46,58.7,112,65.4,2,0
104,2019-05-10 08:40:00,64,70.0,44,58.4,108,65.3,2,0
105,2019-05-10 08:45:00,55,70.2,39,59.4,94,65.7,2,0
106,2019-05-10 08:50:00,58,70.4,41,60.9,99,66.5,2,0
107,2019-05-10 08:55:00,58,70.0,41,58.5,99,65.2,2,0
108,2019-05-10 09:00:00,49,70.4,35,60.6,84,66.3,2,0
109,2019-05-10 09:05:00,50,70.7,36,62.4,86,67.2,2,0
110,2019-05-10 09:10:00,44,70.3,32,60.1,76,66.0,2,0
111,2019-05-10 09:15:00,43,70.2,31,59.5,74,65.7,2,0
112,2019-05-10 09:20:00,53,70.2,37,59.4,90,65.8,2,0
113,2019-05-10 09:25:00,49,70.4,35,60.8,84,66.4,2,0
114,2019-05-10 09:30:00,52,70.6,37,62.2,89,67.1,2,0
115,2019-05-10 09:35:00,45,70.5,32,61.1,77,66.6,2,0
116,2019-05-10 09:40:00,53,70.5,37,61.2,90,66.7,2,0
117,2019-05-10 09:45:00,62,70.7,43,62.7,105,67.4,2,0
118,2019-05-10 09:50:00,53,70.7,37,62.2,90,67.2,2,0
119,2019-05-10 09:55:00,56,70.7,39,62.5,95,67.3,2,0
120,2019-05-10 10:00:00,59,70.5,42,61.5,101,66.8,2,0
121,2019-05-10 10:05:00,52,70.7,37,62.6,89,67.3,2,0
122,2019-05-10 10:10:00,49,70.4,35,60.4,84,66.2,2,0
123,2019-05-10 10:15:00,39,70.5,29,61.3,68,66.6,2,0
124,2019-05-10 10:20:00,49,70.5,35,61.4,84,66.7,2,0
125,2019-05-10 10:25:00,48,70.7,34,62.2,82,67.2,2,0
126,2019-05-10 10:30:00,58,70.6,41,61.6,99,66.9,2,0
127,2019-05-10 10:35:00,52,70.5,37,61.5,89,66.8,2,0
128,2019-05-10 10:40:00,53,70.8,37,63.2,90,67.7,2,0
129,2019-05-10 10:45:00,55,70.6,39,62.2,94,67.1,2,0
130,2019-05-10 10:50:00,52,70.5,37,61.2,89,66.6,2,0
131,2019-05-10 10:55:00,46,70.5,33,61.5,79,66.8,2,0
132,2019-05-10 11:00:00,37,70.7,27,62.3,64,67.1,2,0
133,2019-05-10 11:05:00,45,70.8,32,62.9,77,67.5,2,0
134,2019-05-10 11:10:00,53,70.6,37,61.7,90,66.9,2,0
135,2019-05-10 11:15:00,57,70.8,40,63.0,97,67.6,2,0
136,2019-05-10 11:20:00,47,70.9,34,63.9,81,68.0,2,0
137,2019-05-10 11:25:00,55,70.8,39,63.1,94,67.6,2,0
138,2019-05-10 11:30:00,52,70.5,37,61.6,89,66.8,2,0
139,2019-05-10 11:35:00,47,70.5,34,61.0,81,66.5,2,0
140,2019-05-10 11:40:00,47,70.4,34,60.7,81,66.3,2,0
141,2019-05-10 11:45:00,45,70.2,32,59.7,77,65.9,2,0
142,2019-05-10 11:50:00,58,70.5,41,61.1,99,66.6,2,0
143,2019-05-10 11:55:00,57,70.7,40,62.6,97,67.4,2,0
144,2019-05-10 12:00:00,61,70.7,42,62.4,103,67.3,2,0
145,2019-05-10 12:05:00,47,70.8,34,63.0,81,67.5,2,0
146,2019-05-10 12:10:00,62,70.6,43,61.9,105,67.0,2,0
147,2019-05-10 12:15:00,53,70.5,37,61.3,90,66.7,2,0
148,2019-05-10 12:20:00,43,70.5,31,61.3,74,66.7,2,0
149,2019-05-10 12:25:00,49,70.6,35,61.9,84,67.0,2,0
150,2019-05-10 12:30:00,63,70.8,44,63.3,107,67.8,2,0
151,2019-05-10 12:35:00,64,70.6,44,62.0,108,67.1,2,0
152,2019-05-10 12:40:00,54,70.6,38,62.1,92,67.1,2,0
153,2019-05-10 12:45:00,57,70.4,40,60.8,97,66.5,2,0
154,2019-05-10 12:50:00,44,70.6,32,61.6,76,66.8,2,0
155,2019-05-10 12:55:00,57,70.4,40,60.6,97,66.4,2,0
156,2019-05-10 13:00:00,64,70.3,44,59.9,108,66.0,2,0
157,2019-05-10 13:05:00,59,70.2,42,59.4,101,65.7,2,0
158,2019-05-10 13:10:00,59,69.9,42,57.9,101,64.9,2,0
159,2019-05-10 13:15:00,63,70.0,44,58.2,107,65.1,2,0
160,2019-05-10 13:20:00,71,70.0,49,58.0,120,65.1,2,0
161,2019-05-10 13:25:00,68,70.2,47,59.3,115,65.7,2,0
162,2019-05-10 13:30:00,74,70.1,51,59.0,125,65.6,2,0
163,2019-05-10 13:35:00,61,70.1,42,58.7,103,65.4,2,0
164,2019-05-10 13:40:00,80,70.0,54,58.6,134,65.4,2,0
165,2019-05-10 13:45:00,65,70.0,45,58.2,110,65.1,2,0
166,2019-05-10 13:50:00,81,70.1,55,59.0,136,65.6,2,0
167,2019-05-10 13:55:00,80,70.1,54,58.9,134,65.6,2,0
168,2019-05-10 14:00:00,80,70.0,54,58.6,134,65.4,2,0
169,2019-05-10 14:05:00,55,70.0,39,58.3,94,65.1,2,0
170,2019-05-10 14:10:00,66,70.0,46,58.3,112,65.2,2,0
171,2019-05-10 14:15:00,80,70.0,54,58.5,134,65.4,2,0
172,2019-05-10 14:20:00,66,69.8,46,57.2,112,64.7,2,0
173,2019-05-10 14:25:00,71,70.0,49,58.2,120,65.2,2,0
174,2019-05-10 14:30:00,75,70.0,51,58.2,126,65.2,2,0
175,2019-05-10 14:35:00,61,70.1,42,59.0,103,65.6,2,0
176,2019-05-10 14:40:00,67,70.1,46,59.2,113,65.7,2,0
177,2019-05-10 14:45:00,65,70.4,45,60.7,110,66.4,2,0
178,2019-05-10 14:50:00,76,70.3,52,59.8,128,66.0,2,0
179,2019-05-10 14:55:00,79,70.3,54,59.9,133,66.1,2,0
180,2019-05-10 15:00:00,66,70.1,46,59.2,112,65.6,2,0
181,2019-05-10 15:05:00,65,70.1,45,58.8,110,65.5,2,0
182,2019-05-10 15:10:00,64,70.2,44,59.4,108,65.8,2,0
183,2019-05-10 15:15:00,64,70.2,44,59.5,108,65.8,2,0
184,2019-05-10 15:20:00,90,70.3,61,59.9,151,66.1,2,0
185,2019-05-10 15:25:00,72,70.1,49,59.0,121,65.6,2,0
186,2019-05-10 15:30:00,83,70.4,56,60.4,139,66.3,2,0
187,2019-05-10 15:35:00,68,70.4,47,60.9,115,66.5,2,0
188,2019-05-10 15:40:00,73,70.2,50,59.4,123,65.8,2,0
189,2019-05-10 15:45:00,80,70.3,54,60.4,134,66.3,2,0
190,2019-05-10 15:50:00,68,70.5,47,61.4,115,66.8,2,0
191,2019-05-10 15:55:00,68,70.3,47,60.3,115,66.3,2,0
192,2019-05-10 16:00:00,58,70.3,41,60.0,99,66.0,2,0
193,2019-05-10 16:05:00,81,70.5,55,61.4,136,66.8,2,0
194,2019-05-10 16:10:00,63,70.5,44,61.2,107,66.7,2,0
195,2019-05-10 16:15:00,63,70.5,44,61.0,107,66.6,2,0
196,2019-05-10 16:20:00,66,70.5,46,61.5,112,66.8,2,0
197,2019-05-10 16:25:00,63,70.7,44,62.2,107,67.2,2,0
198,2019-05-10 16:30:00,68,70.6,47,62.1,115,67.1,2,0
199,2019-05-10 16:35:00,64,70.8,44,62.8,108,67.5,2,0
200,2019-05-10 16:40:00,71,70.7,49,62.8,120,67.5,2,0
201,2019-05-10 16:45:00,64,70.4,44,60.7,108,66.4,2,0
202,2019-05-10 16:50:00,63,70.5,44,61.1,107,66.6,2,0
203,2019-05-10 16:55:00,64,70.5,44,61.5,108,66.8,2,0
204,2019-05-10 17:00:00,72,70.6,49,62.0,121,67.1,2,0
205,2019-05-10 17:05:00,58,70.5,41,61.6,99,66.8,2,0
206,2019-05-10 17:10:00,61,70.4,42,60.9,103,66.6,2,0
207,2019-05-10 17:15:00,63,70.5,44,61.3,107,66.7,2,0
208,2019-05-10 17:20:00,68,70.4,47,60.6,115,66.4,2,0
209,2019-05-10 17:25:00,68,70.5,47,61.1,115,66.6,2,0
210,2019-05-10 17:30:00,70,70.3,48,60.4,118,66.3,2,0
211,2019-05-10 17:35:00,76,70.4,52,60.7,128,66.4,2,0
212,2019-05-10 17:40:00,64,70.5,44,61.2,108,66.7,2,0
213,2019-05-10 17:45:00,68,70.3,47,60.3,115,66.3,2,0
214,2019-05-10 17:50:00,64,70.5,44,61.1,108,66.7,2,0
215,2019-05-10 17:55:00,59,70.4,42,60.6,101,66.3,2,0
216,2019-05-10 18:00:00,65,70.7,45,62.2,110,67.2,2,0
217,2019-05-10 18:05:00,57,70.7,40,62.6,97,67.4,2,0
218,2019-05-10 18:10:00,49,70.7,35,62.3,84,67.2,2,0
219,2019-05-10 18:15:00,74,70.7,51,62.3,125,67.2,2,0
220,2019-05-10 18:20:00,70,70.6,48,62.0,118,67.1,2,0
221,2019-05-10 18:25:00,70,70.6,48,61.7,118,67.0,2,0
222,2019-05-10 18:30:00,54,70.8,38,62.8,92,67.5,2,0
223,2019-05-10 18:35:00,66,70.7,46,62.4,112,67.3,2,0
224,2019-05-10 18:40:00,57,70.6,40,62.1,97,67.1,2,0
225,2019-05-10 18:45:00,58,70.8,41,62.8,99,67.5,2,0
226,2019-05-10 18:50:00,48,70.7,34,62.4,82,67.2,2,0
227,2019-05-10 18:55:00,59,70.7,42,62.3,101,67.2,2,0
228,2019-05-10 19:00:00,59,70.5,42,61.6,101,66.8,2,0
229,2019-05-10 19:05:00,54,70.5,38,61.2,92,66.6,2,0
230,2019-05-10 19:10:00,62,70.4,43,60.6,105,66.4,2,0
231,2019-05-10 19:15:00,47,70.5,34,61.3,81,66.7,2,0
232,2019-05-10 19:20:00,48,70.7,34,62.2,82,67.1,2,0
233,2019-05-10 19:25:00,56,70.7,39,62.5,95,67.4,2,0
234,2019-05-10 19:30:00,44,70.8,32,63.0,76,67.5,2,0
235,2019-05-10 19:35:00,49,70.7,35,62.4,84,67.3,2,0
236,2019-05-10 19:40:00,40,70.6,30,61.8,70,66.8,2,0
237,2019-05-10 19:45:00,40,70.7,30,62.4,70,67.1,2,0
238,2019-05-10 19:50:00,40,70.6,30,61.9,70,66.9,2,0
239,2019-05-10 19:55:00,44,70.5,32,61.2,76,66.6,2,0
240,2019-05-10 20:00:00,40,70.6,30,62.1,70,67.0,2,0
241,2019-05-10 20:05:00,43,70.6,31,61.7,74,66.9,2,0
242,2019-05-10 20:10:00,31,70.6,24,61.7,55,66.7,2,0
243,2019-05-10 20:15:00,34,70.6,25,61.6,59,66.8,2,0
244,2019-05-10 20:20:00,34,70.7,25,62.5,59,67.3,2,0
245,2019-05-10 20:25:00,27,70.7,21,62.3,48,67.0,2,0
246,2019-05-10 20:30:00,27,70.6,21,62.0,48,66.8,2,0
247,2019-05-10 20:35:00,36,70.6,27,62.0,63,66.9,2,0
248,2019-05-10 20:40:00,20,70.6,17,61.8,37,66.6,2,0
249,2019-05-10 20:45:00,23,70.6,19,61.7,42,66.6,2,0
250,2019-05-10 20:50:00,22,70.4,18,60.9,40,66.1,2,0
251,2019-05-10 20:55:00,34,70.4,25,60.8,59,66.3,2,0
252,2019-05-10 21:00:00,38,70.2,28,59.5,66,65.7,2,0
253,2019-05-10 21:05:00,26,70.3,20,60.1,46,65.9,2,0
254,2019-05-10 21:10:00,38,70.4,28,60.9,66,66.4,2,0
255,2019-05-10 21:15:00,36,70.4,27,60.8,63,66.3,2,0
256,2019-05-10 21:20:00,27,70.5,21,61.3,48,66.5,2,0
257,2019-05-10 21:25:00,32,70.4,25,60.7,57,66.2,2,0
258,2019-05-10 21:30:00,31,70.4,24,60.7,55,66.2,2,0
259,2019-05-10 21:35:00,27,70.2,21,59.5,48,65.5,2,0
260,2019-05-10 21:40:00,34,70.3,25,60.2,59,66.0,2,0
261,2019-05-10 21:45:00,23,70.5,19,61.3,42,66.4,2,0
262,2019-05-10 21:50:00,35,70.4,26,60.9,61,66.4,2,0
263,2019-05-10 21:55:00,32,70.5,25,61.1,57,66.4,2,0
264,2019-05-10 22:00:00,28,70.6,22,61.7,50,66.7,2,0
265,2019-05-10 22:05:00,35,70.7,26,62.3,61,67.1,2,0
266,2019-05-10 22:10:00,23,70.7,19,62.5,42,67.0,2,0
267,2019-05-10 22:15:00,20,70.6,17,62.0,37,66.7,2,0
268,2019-05-10 22:20:00,23,70.7,19,62.4,42,66.9,2,0
269,2019-05-10 22:25:00,38,70.8,28,63.1,66,67.5,2,0
270,2019-05-10 22:30:00,17,70.8,15,62.9,32,67.1,2,0
271,2019-05-10 22:35:00,19,70.8,16,62.8,35,67.1,2,0
272,2019-05-10 22:40:00,26,70.7,20,62.5,46,67.1,2,0
273,2019-05-10 22:45:00,21,70.5,17,61.5,38,66.5,2,0
274,2019-05-10 22:50:00,28,70.6,22,61.9,50,66.8,2,0
275,2019-05-10 22:55:00,14,70.6,13,61.7,27,66.3,2,0
276,2019-05-10 23:00:00,21,70.6,17,61.6,38,66.6,2,0
277,2019-05-10 23:05:00,17,70.6,15,62.1,32,66.6,2,0
278,2019-05-10 23:10:00,18,70.7,15,62.3,33,66.9,2,0
279,2019-05-10 23:15:00,19,70.7,16,62.4,35,66.9,2,0
280,2019-05-10 23:20:00,17,70.7,15,62.3,32,66.7,2,0
281,2019-05-10 23:25:00,12,70.6,12,61.7,24,66.1,2,0
282,2019-05-10 23:30:00,14,70.6,13,61.7,27,66.3,2,0
283,2019-05-10 23:35:00,19,70.7,16,62.2,35,66.8,2,0
284,2019-05-10 23:40:00,11,70.4,11,60.5,22,65.5,2,0
285,2019-05-10 23:45:00,14,70.5,13,61.5,27,66.2,2,0
286,2019-05-10 23:50:00,9,70.6,10,62.0,19,66.1,2,0
287,2019-05-10 23:55:00,9,70.6,10,62.1,19,66.2,2,0
288,2019-05-11 00:00:00,9,70.7,10,62.2,19,66.2,2,0
289,2019-05-11 00:05:00,10,70.6,10,62.0,20,66.3,2,0
290,2019-05-11 00:10:00,10,70.6,10,62.1,20,66.3,2,0
291,2019-05-11 00:15:00,11,70.7,11,62.2,22,66.4,2,0
292,2019-05-11 00:20:00,2,70.6,5,62.0,7,64.5,2,0
293,2019-05-11 00:25:00,10,70.7,10,62.3,20,66.5,2,0
294,2019-05-11 00:30:00,2,70.7,5,62.3,7,64.7,2,0
295,2019-05-11 00:35:00,9,70.7,10,62.4,19,66.3,2,0
296,2019-05-11 00:40:00,7,70.6,8,62.2,15,66.1,2,0
297,2019-05-11 00:45:00,5,70.6,8,61.8,13,65.2,2,0
298,2019-05-11 00:50:00,4,70.6,7,62.0,11,65.1,2,0
299,2019-05-11 00:55:00,3,70.7,6,62.2,9,65.0,2,0
300,2019-05-11 01:00:00,2,70.6,5,62.0,7,64.4,2,0
301,2019-05-11 01:05:00,2,70.6,5,62.0,7,64.5,2,0
302,2019-05-11 01:10:00,2,70.6,5,61.6,7,64.1,2,0
303,2019-05-11 01:15:00,3,70.6,6,62.0,9,64.9,2,0
304,2019-05-11 01:20:00,2,70.7,5,62.2,7,64.6,2,0
305,2019-05-11 01:25:00,2,70.7,5,62.3,7,64.7,2,0
306,2019-05-11 01:30:00,7,70.6,8,62.0,15,66.0,2,0
307,2019-05-11 01:35:00,7,70.6,8,61.8,15,65.9,2,0
308,2019-05-11 01:40:00,13,65.8,3,62.0,16,65.1,2,0
309,2019-05-11 01:45:00,13,66.2,3,62.2,16,65.5,2,0
310,2019-05-11 01:50:00,4,70.6,7,62.2,11,65.2,2,0
311,2019-05-11 01:55:00,11,65.8,1,62.1,12,65.5,2,0
312,2019-05-11 02:00:00,10,66.1,1,62.2,11,65.8,2,0
313,2019-05-11 02:05:00,14,64.8,4,61.6,18,64.1,2,0
314,2019-05-11 02:10:00,13,64.8,3,61.6,16,64.2,2,0
315,2019-05-11 02:15:00,2,70.6,5,61.7,7,64.2,2,0
316,2019-05-11 02:20:00,13,65.8,3,62.1,16,65.1,2,0
317,2019-05-11 02:25:00,13,65.8,3,62.1,16,65.1,2,0
318,2019-05-11 02:30:00,14,65.9,4,62.1,18,65.1,2,0
319,2019-05-11 02:35:00,13,66.3,3,62.3,16,65.5,2,0
320,2019-05-11 02:40:00,1,70.6,5,62.0,6,63.4,2,0
321,2019-05-11 02:45:00,1,70.6,5,61.7,6,63.2,2,0
322,2019-05-11 02:50:00,11,65.3,1,61.8,12,65.0,2,0
323,2019-05-11 02:55:00,13,65.8,3,62.1,16,65.1,2,0
324,2019-05-11 03:00:00,13,66.1,3,62.2,16,65.3,2,0
325,2019-05-11 03:05:00,1,70.6,5,62.1,6,63.5,2,0
326,2019-05-11 03:10:00,14,66.5,4,62.4,18,65.6,2,0
327,2019-05-11 03:15:00,14,66.3,4,62.3,18,65.4,2,0
328,2019-05-11 03:20:00,2,70.6,5,62.1,7,64.5,2,0
329,2019-05-11 03:25:00,11,66.3,1,62.3,12,66.0,2,0
330,2019-05-11 03:30:00,13,66.6,3,62.4,16,65.8,2,0
331,2019-05-11 03:35:00,12,66.6,2,62.4,14,66.0,2,0
332,2019-05-11 03:40:00,12,66.2,2,62.2,14,65.6,2,0
333,2019-05-11 03:45:00,3,70.6,6,61.8,9,64.7,2,0
334,2019-05-11 03:50:00,13,66.0,3,62.1,16,65.3,2,0
335,2019-05-11 03:55:00,12,66.3,2,62.3,14,65.7,2,0
336,2019-05-11 04:00:00,13,66.6,3,62.4,16,65.8,2,0
337,2019-05-11 04:05:00,12,65.6,2,61.9,14,65.0,2,0
338,2019-05-11 04:10:00,2,70.6,5,61.9,7,64.4,2,0
339,2019-05-11 04:15:00,14,65.6,4,62.0,18,64.8,2,0
340,2019-05-11 04:20:00,13,65.8,3,62.1,16,65.1,2,0
341,2019-05-11 04:25:00,13,65.8,3,62.1,16,65.1,2,0
342,2019-05-11 04:30:00,12,65.7,2,62.0,14,65.2,2,0
343,2019-05-11 04:35:00,13,65.4,3,61.9,16,64.8,2,0
344,2019-05-11 04:40:00,14,66.1,4,62.2,18,65.3,2,0
345,2019-05-11 04:45:00,13,66.5,3,62.4,16,65.7,2,0
346,2019-05-11 04:50:00,5,70.7,8,62.5,13,65.7,2,0
347,2019-05-11 04:55:00,1,70.7,5,62.4,6,63.8,2,0
348,2019-05-11 05:00:00,2,70.7,5,62.4,7,64.8,2,0
349,2019-05-11 05:05:00,4,70.7,7,62.3,11,65.3,2,0
350,2019-05-11 05:10:00,2,70.7,5,62.4,7,64.7,2,0
351,2019-05-11 05:15:00,14,66.4,4,62.3,18,65.5,2,0
352,2019-05-11 05:20:00,4,70.7,7,62.2,11,65.3,2,0
353,2019-05-11 05:25:00,3,70.7,6,62.2,9,65.0,2,0
354,2019-05-11 05:30:00,10,70.5,10,61.3,20,65.9,2,0
355,2019-05-11 05:35:00,8,70.5,9,61.0,17,65.5,2,0
356,2019-05-11 05:40:00,3,70.6,6,61.6,9,64.6,2,0
357,2019-05-11 05:45:00,7,70.6,8,62.0,15,66.0,2,0
358,2019-05-11 05:50:00,14,70.6,13,61.8,27,66.4,2,0
359,2019-05-11 05:55:00,5,70.6,8,62.0,13,65.3,2,0
360,2019-05-11 06:00:00,7,70.6,8,62.1,15,66.1,2,0
361,2019-05-11 06:05:00,8,70.7,9,62.4,17,66.3,2,0
362,2019-05-11 06:10:00,3,70.7,6,62.3,9,65.1,2,0
363,2019-05-11 06:15:00,3,70.6,6,61.8,9,64.7,2,0
364,2019-05-11 06:20:00,10,70.6,10,62.0,20,66.3,2,0
365,2019-05-11 06:25:00,12,70.7,12,62.5,24,66.6,2,0
366,2019-05-11 06:30:00,12,70.7,12,62.3,24,66.5,2,0
367,2019-05-11 06:35:00,19,70.6,16,61.9,35,66.6,2,0
368,2019-05-11 06:40:00,17,70.7,15,62.6,32,66.9,2,0
369,2019-05-11 06:45:00,17,70.5,15,61.4,32,66.2,2,0
370,2019-05-11 06:50:00,11,70.5,11,61.3,22,65.9,2,0
371,2019-05-11 06:55:00,22,70.7,18,62.5,40,67.0,2,0
372,2019-05-11 07:00:00,14,70.5,13,61.3,27,66.1,2,0
373,2019-05-11 07:05:00,14,70.4,13,60.7,27,65.7,2,0
374,2019-05-11 07:10:00,22,70.5,18,61.4,40,66.4,2,0
375,2019-05-11 07:15:00,26,70.7,20,62.3,46,67.0,2,0
376,2019-05-11 07:20:00,31,70.7,24,62.7,55,67.2,2,0
377,2019-05-11 07:25:00,25,70.7,20,62.6,45,67.1,2,0
378,2019-05-11 07:30:00,40,70.7,30,62.7,70,67.3,2,0
379,2019-05-11 07:35:00,38,70.9,28,63.5,66,67.7,2,0
380,2019-05-11 07:40:00,25,70.8,20,63.0,45,67.3,2,0
381,2019-05-11 07:45:00,40,70.7,30,62.4,70,67.2,2,0
382,2019-05-11 07:50:00,27,70.6,21,62.0,48,66.9,2,0
383,2019-05-11 07:55:00,30,70.7,23,62.6,53,67.2,2,0
384,2019-05-11 08:00:00,23,70.7,19,62.6,42,67.1,2,0
385,2019-05-11 08:05:00,36,70.7,27,62.6,63,67.2,2,0
386,2019-05-11 08:10:00,39,70.8,29,63.3,68,67.6,2,0
387,2019-05-11 08:15:00,38,70.7,28,62.3,66,67.1,2,0
388,2019-05-11 08:20:00,39,70.7,29,62.5,68,67.2,2,0
389,2019-05-11 08:25:00,36,70.5,27,61.5,63,66.7,2,0
390,2019-05-11 08:30:00,48,70.8,34,62.8,82,67.5,2,0
391,2019-05-11 08:35:00,28,70.7,22,62.3,50,67.0,2,0
392,2019-05-11 08:40:00,44,70.7,32,62.7,76,67.3,2,0
393,2019-05-11 08:45:00,44,70.7,32,62.7,76,67.4,2,0
394,2019-05-11 08:50:00,47,70.7,34,62.6,81,67.3,2,0
395,2019-05-11 08:55:00,45,70.8,32,63.0,77,67.6,2,0
396,2019-05-11 09:00:00,41,70.7,30,62.7,71,67.3,2,0
397,2019-05-11 09:05:00,47,70.6,34,61.7,81,66.9,2,0
398,2019-05-11 09:10:00,37,70.6,27,62.0,64,67.0,2,0
399,2019-05-11 09:15:00,46,70.5,33,61.3,79,66.6,2,0
400,2019-05-11 09:20:00,36,70.6,27,61.8,63,66.8,2,0
401,2019-05-11 09:25:00,41,70.7,30,62.2,71,67.1,2,0
402,2019-05-11 09:30:00,37,70.7,27,62.2,64,67.1,2,0
403,2019-05-11 09:35:00,43,70.8,31,63.1,74,67.6,2,0
404,2019-05-11 09:40:00,54,70.5,38,61.5,92,66.8,2,0
405,2019-05-11 09:45:00,66,70.8,46,62.8,112,67.5,2,0
406,2019-05-11 09:50:00,50,70.8,36,62.8,86,67.4,2,0
407,2019-05-11 09:55:00,56,70.8,39,62.9,95,67.6,2,0
408,2019-05-11 10:00:00,57,70.8,40,63.0,97,67.6,2,0
409,2019-05-11 10:05:00,54,70.8,38,63.0,92,67.6,2,0
410,2019-05-11 10:10:00,48,70.8,34,63.3,82,67.7,2,0
411,2019-05-11 10:15:00,50,70.8,36,62.9,86,67.5,2,0
412,2019-05-11 10:20:00,50,70.9,36,63.5,86,67.8,2,0
413,2019-05-11 10:25:00,49,70.7,35,62.4,84,67.2,2,0
414,2019-05-11 10:30:00,48,70.6,34,61.9,82,67.0,2,0
415,2019-05-11 10:35:00,57,70.7,40,62.5,97,67.3,2,0
416,2019-05-11 10:40:00,50,70.8,36,63.3,86,67.7,2,0
417,2019-05-11 10:45:00,71,70.7,49,62.3,120,67.2,2,0
418,2019-05-11 10:50:00,63,70.6,44,62.0,107,67.1,2,0
419,2019-05-11 10:55:00,74,70.6,51,62.1,125,67.1,2,0
420,2019-05-11 11:00:00,57,70.6,40,61.7,97,66.9,2,0
421,2019-05-11 11:05:00,46,70.3,33,60.1,79,66.1,2,0
422,2019-05-11 11:10:00,39,70.5,29,61.5,68,66.7,2,0
423,2019-05-11 11:15:00,59,70.4,42,60.7,101,66.3,2,0
424,2019-05-11 11:20:00,64,70.3,44,60.1,108,66.1,2,0
425,2019-05-11 11:25:00,53,70.4,37,60.6,90,66.4,2,0
426,2019-05-11 11:30:00,52,70.5,37,61.3,89,66.7,2,0
427,2019-05-11 11:35:00,55,70.6,39,61.6,94,66.8,2,0
428,2019-05-11 11:40:00,62,70.4,43,61.0,105,66.6,2,0
429,2019-05-11 11:45:00,67,70.5,46,61.4,113,66.8,2,0
430,2019-05-11 11:50:00,50,70.7,36,62.2,86,67.1,2,0
431,2019-05-11 11:55:00,57,70.5,40,61.3,97,66.7,2,0
432,2019-05-11 12:00:00,56,70.4,39,60.7,95,66.4,2,0
433,2019-05-11 12:05:00,64,70.6,44,61.6,108,66.9,2,0
434,2019-05-11 12:10:00,58,70.2,41,59.6,99,65.8,2,0
435,2019-05-11 12:15:00,64,70.4,44,60.9,108,66.5,2,0
436,2019-05-11 12:20:00,63,70.7,44,62.3,107,67.2,2,0
437,2019-05-11 12:25:00,63,70.8,44,62.8,107,67.5,2,0
438,2019-05-11 12:30:00,57,70.7,40,62.7,97,67.4,2,0
439,2019-05-11 12:35:00,70,70.8,48,63.1,118,67.6,2,0
440,2019-05-11 12:40:00,68,70.6,47,62.1,115,67.1,2,0
441,2019-05-11 12:45:00,71,70.5,49,61.4,120,66.8,2,0
442,2019-05-11 12:50:00,63,70.6,44,61.7,107,66.9,2,0
443,2019-05-11 12:55:00,66,70.7,46,62.4,112,67.3,2,0
444,2019-05-11 13:00:00,71,70.7,49,62.4,120,67.3,2,0
445,2019-05-11 13:05:00,65,70.7,45,62.8,110,67.5,2,0
446,2019-05-11 13:10:00,61,70.6,42,61.9,103,67.1,2,0
447,2019-05-11 13:15:00,72,70.7,49,62.3,121,67.3,2,0
448,2019-05-11 13:20:00,71,70.6,49,61.9,120,67.1,2,0
449,2019-05-11 13:25:00,82,70.7,56,62.4,138,67.3,2,0
450,2019-05-11 13:30:00,63,70.6,44,61.8,107,67.0,2,0
451,2019-05-11 13:35:00,70,70.5,48,61.4,118,66.8,2,0
452,2019-05-11 13:40:00,62,70.6,43,61.9,105,67.0,2,0
453,2019-05-11 13:45:00,74,70.6,51,62.0,125,67.1,2,0
454,2019-05-11 13:50:00,74,70.6,51,62.0,125,67.1,2,0
455,2019-05-11 13:55:00,63,70.8,44,63.1,107,67.7,2,0
456,2019-05-11 14:00:00,72,70.7,49,62.4,121,67.3,2,0
457,2019-05-11 14:05:00,66,70.6,46,61.7,112,67.0,2,0
458,2019-05-11 14:10:00,64,70.7,44,62.6,108,67.4,2,0
459,2019-05-11 14:15:00,68,70.7,47,62.5,115,67.3,2,0
460,2019-05-11 14:20:00,67,70.6,46,62.1,113,67.2,2,0
461,2019-05-11 14:25:00,76,70.7,52,62.2,128,67.2,2,0
462,2019-05-11 14:30:00,71,70.7,49,62.2,120,67.2,2,0
463,2019-05-11 14:35:00,76,70.6,52,62.0,128,67.1,2,0
464,2019-05-11 14:40:00,65,70.6,45,61.6,110,66.9,2,0
465,2019-05-11 14:45:00,74,70.7,51,62.6,125,67.4,2,0
466,2019-05-11 14:50:00,76,70.7,52,62.7,128,67.5,2,0
467,2019-05-11 14:55:00,74,70.7,51,62.3,125,67.3,2,0
468,2019-05-11 15:00:00,67,70.7,46,62.6,113,67.4,2,0
469,2019-05-11 15:05:00,62,70.6,43,62.1,105,67.2,2,0
470,2019-05-11 15:10:00,68,70.6,47,61.8,115,67.0,2,0
471,2019-05-11 15:15:00,55,70.7,39,62.3,94,67.2,2,0
472,2019-05-11 15:20:00,63,70.6,44,62.1,107,67.1,2,0
473,2019-05-11 15:25:00,65,70.6,45,61.7,110,67.0,2,0
474,2019-05-11 15:30:00,73,70.6,50,61.6,123,66.9,2,0
475,2019-05-11 15:35:00,72,70.5,49,61.5,121,66.9,2,0
476,2019-05-11 15:40:00,61,70.6,42,62.1,103,67.1,2,0
477,2019-05-11 15:45:00,61,70.5,42,61.5,103,66.9,2,0
478,2019-05-11 15:50:00,61,70.6,42,61.8,103,67.0,2,0
479,2019-05-11 15:55:00,54,70.5,38,61.3,92,66.7,2,0
480,2019-05-11 16:00:00,57,70.3,40,59.9,97,66.0,2,0
481,2019-05-11 16:05:00,75,70.5,51,61.2,126,66.7,2,0
482,2019-05-11 16:10:00,64,70.5,44,61.2,108,66.7,2,0
483,2019-05-11 16:15:00,66,70.5,46,61.3,112,66.7,2,0
484,2019-05-11 16:20:00,70,70.4,48,60.9,118,66.5,2,0
485,2019-05-11 16:25:00,73,70.4,50,60.9,123,66.6,2,0
486,2019-05-11 16:30:00,54,70.6,38,61.7,92,66.9,2,0
487,2019-05-11 16:35:00,61,70.7,42,62.4,103,67.3,2,0
488,2019-05-11 16:40:00,66,70.7,46,62.4,112,67.3,2,0
489,2019-05-11 16:45:00,70,70.7,48,62.7,118,67.5,2,0
490,2019-05-11 16:50:00,61,70.6,42,62.1,103,67.2,2,0
491,2019-05-11 16:55:00,76,70.7,52,62.5,128,67.4,2,0
492,2019-05-11 17:00:00,59,70.6,42,62.1,101,67.1,2,0
493,2019-05-11 17:05:00,64,70.6,44,62.1,108,67.1,2,0
494,2019-05-11 17:10:00,57,70.6,40,62.1,97,67.1,2,0
495,2019-05-11 17:15:00,55,70.6,39,62.1,94,67.1,2,0
496,2019-05-11 17:20:00,68,70.7,47,62.2,115,67.2,2,0
497,2019-05-11 17:25:00,50,70.7,36,62.6,86,67.3,2,0
498,2019-05-11 17:30:00,62,70.6,43,62.0,105,67.1,2,0
499,2019-05-11 17:35:00,55,70.5,39,61.0,94,66.6,2,0
500,2019-05-11 17:40:00,50,70.5,36,61.0,86,66.5,2,0
501,2019-05-11 17:45:00,66,70.5,46,61.5,112,66.8,2,0
502,2019-05-11 17:50:00,70,70.6,48,62.0,118,67.1,2,0
503,2019-05-11 17:55:00,56,70.6,39,62.1,95,67.1,2,0
504,2019-05-11 18:00:00,50,70.7,36,62.2,86,67.1,2,0
505,2019-05-11 18:05:00,68,70.6,47,61.7,115,67.0,2,0
506,2019-05-11 18:10:00,57,70.6,40,61.8,97,67.0,2,0
507,2019-05-11 18:15:00,67,70.6,46,61.7,113,67.0,2,0
508,2019-05-11 18:20:00,57,70.5,40,61.5,97,66.8,2,0
509,2019-05-11 18:25:00,62,70.3,43,59.9,105,66.0,2,0
510,2019-05-11 18:30:00,71,70.3,49,60.2,120,66.2,2,0
511,2019-05-11 18:35:00,70,70.4,48,61.0,118,66.6,2,0
512,2019-05-11 18:40:00,71,70.5,49,61.3,120,66.7,2,0
513,2019-05-11 18:45:00,62,70.6,43,61.7,105,66.9,2,0
514,2019-05-11 18:50:00,62,70.7,43,62.2,105,67.2,2,0
515,2019-05-11 18:55:00,61,70.7,42,62.4,103,67.3,2,0
516,2019-05-11 19:00:00,44,70.7,32,62.4,76,67.2,2,0
517,2019-05-11 19:05:00,50,70.7,36,62.3,86,67.2,2,0
518,2019-05-11 19:10:00,40,70.6,30,62.0,70,66.9,2,0
519,2019-05-11 19:15:00,47,70.7,34,62.6,81,67.3,2,0
520,2019-05-11 19:20:00,46,70.8,33,63.0,79,67.5,2,0
521,2019-05-11 19:25:00,49,70.6,35,62.1,84,67.1,2,0
522,2019-05-11 19:30:00,50,70.6,36,61.8,86,66.9,2,0
523,2019-05-11 19:35:00,41,70.6,30,62.1,71,67.0,2,0
524,2019-05-11 19:40:00,58,70.7,41,62.6,99,67.4,2,0
525,2019-05-11 19:45:00,36,70.6,27,61.9,63,66.9,2,0
526,2019-05-11 19:50:00,56,70.6,39,61.6,95,66.9,2,0
527,2019-05-11 19:55:00,54,70.6,38,61.9,92,67.0,2,0
528,2019-05-11 20:00:00,44,70.6,32,62.0,76,67.0,2,0
529,2019-05-11 20:05:00,43,70.7,31,62.2,74,67.1,2,0
530,2019-05-11 20:10:00,47,70.8,34,63.0,81,67.5,2,0
531,2019-05-11 20:15:00,40,70.8,30,63.2,70,67.5,2,0
532,2019-05-11 20:20:00,40,70.7,30,62.7,70,67.3,2,0
533,2019-05-11 20:25:00,37,70.8,27,62.9,64,67.4,2,0
534,2019-05-11 20:30:00,36,70.6,27,61.9,63,66.9,2,0
535,2019-05-11 20:35:00,41,70.6,30,61.9,71,66.9,2,0
536,2019-05-11 20:40:00,37,70.7,27,62.4,64,67.2,2,0
537,2019-05-11 20:45:00,31,70.7,24,62.7,55,67.2,2,0
538,2019-05-11 20:50:00,34,70.7,25,62.4,59,67.2,2,0
539,2019-05-11 20:55:00,34,70.7,25,62.3,59,67.1,2,0
540,2019-05-11 21:00:00,28,70.6,22,61.7,50,66.7,2,0
541,2019-05-11 21:05:00,31,70.5,24,61.2,55,66.4,2,0
542,2019-05-11 21:10:00,34,70.6,25,61.6,59,66.8,2,0
543,2019-05-11 21:15:00,28,70.6,22,62.1,50,66.9,2,0
544,2019-05-11 21:20:00,27,70.7,21,62.3,48,67.0,2,0
545,2019-05-11 21:25:00,34,70.5,25,61.3,59,66.6,2,0
546,2019-05-11 21:30:00,37,70.6,27,61.6,64,66.8,2,0
547,2019-05-11 21:35:00,28,70.6,22,62.0,50,66.8,2,0
548,2019-05-11 21:40:00,26,70.7,20,62.3,46,67.0,2,0
549,2019-05-11 21:45:00,36,70.7,27,62.5,63,67.2,2,0
550,2019-05-11 21:50:00,25,70.7,20,62.4,45,67.0,2,0
551,2019-05-11 21:55:00,28,70.7,22,62.3,50,67.0,2,0
552,2019-05-11 22:00:00,32,70.7,25,62.6,57,67.1,2,0
553,2019-05-11 22:05:00,17,70.7,15,62.4,32,66.8,2,0
554,2019-05-11 22:10:00,32,70.7,25,62.3,57,67.0,2,0
555,2019-05-11 22:15:00,21,70.6,17,61.6,38,66.6,2,0
556,2019-05-11 22:20:00,23,70.6,19,61.9,42,66.7,2,0
557,2019-05-11 22:25:00,22,70.6,18,61.6,40,66.6,2,0
558,2019-05-11 22:30:00,22,70.6,18,62.0,40,66.8,2,0
559,2019-05-11 22:35:00,29,70.7,22,62.4,51,67.1,2,0
560,2019-05-11 22:40:00,27,70.7,21,62.6,48,67.2,2,0
561,2019-05-11 22:45:00,23,70.8,19,62.8,42,67.2,2,0
562,2019-05-11 22:50:00,13,70.7,13,62.2,26,66.4,2,0
563,2019-05-11 22:55:00,32,70.6,25,62.1,57,66.9,2,0
564,2019-05-11 23:00:00,20,70.6,17,62.1,37,66.7,2,0
565,2019-05-11 23:05:00,26,70.7,20,62.2,46,67.0,2,0
566,2019-05-11 23:10:00,10,70.7,10,62.3,20,66.5,2,0
567,2019-05-11 23:15:00,19,70.6,16,61.7,35,66.5,2,0
568,2019-05-11 23:20:00,14,70.6,13,61.7,27,66.3,2,0
569,2019-05-11 23:25:00,20,70.5,17,61.3,37,66.3,2,0
570,2019-05-11 23:30:00,14,70.6,13,61.8,27,66.4,2,0
571,2019-05-11 23:35:00,19,70.6,16,61.8,35,66.6,2,0
572,2019-05-11 23:40:00,10,70.6,10,62.1,20,66.3,2,0
573,2019-05-11 23:45:00,21,70.6,17,62.0,38,66.8,2,0
574,2019-05-11 23:50:00,11,70.7,11,62.2,22,66.4,2,0
575,2019-05-11 23:55:00,9,70.7,10,62.3,19,66.2,2,0
576,2019-05-12 00:00:00,14,70.7,13,62.2,27,66.6,2,0
577,2019-05-12 00:05:00,13,70.7,13,62.4,26,66.6,2,0
578,2019-05-12 00:10:00,14,70.7,13,62.5,27,66.8,2,0
579,2019-05-12 00:15:00,10,70.7,10,62.5,20,66.6,2,0
580,2019-05-12 00:20:00,7,70.7,8,62.2,15,66.1,2,0
581,2019-05-12 00:25:00,3,70.7,6,62.3,9,65.1,2,0
582,2019-05-12 00:30:00,13,70.6,13,61.9,26,66.2,2,0
583,2019-05-12 00:35:00,3,70.6,6,62.1,9,65.0,2,0
584,2019-05-12 00:40:00,14,70.7,13,62.3,27,66.7,2,0
585,2019-05-12 00:45:00,13,66.5,3,62.4,16,65.7,2,0
586,2019-05-12 00:50:00,4,70.7,7,62.4,11,65.4,2,0
587,2019-05-12 00:55:00,4,70.7,7,62.4,11,65.4,2,0
588,2019-05-12 01:00:00,8,70.7,9,62.5,17,66.4,2,0
589,2019-05-12 01:05:00,4,70.7,7,62.3,11,65.3,2,0
590,2019-05-12 01:10:00,16,70.6,14,62.1,30,66.6,2,0
591,2019-05-12 01:15:00,2,70.6,5,61.7,7,64.2,2,0
592,2019-05-12 01:20:00,4,70.6,7,62.0,11,65.1,2,0
593,2019-05-12 01:25:00,2,70.7,5,62.2,7,64.6,2,0
594,2019-05-12 01:30:00,3,70.7,6,62.4,9,65.2,2,0
595,2019-05-12 01:35:00,13,66.6,3,62.4,16,65.8,2,0
596,2019-05-12 01:40:00,5,70.6,8,62.1,13,65.4,2,0
597,2019-05-12 01:45:00,7,70.7,8,62.3,15,66.2,2,0
598,2019-05-12 01:50:00,3,70.6,6,62.2,9,65.0,2,0
599,2019-05-12 01:55:00,13,66.3,3,62.3,16,65.6,2,0
600,2019-05-12 02:00:00,2,70.7,5,62.3,7,64.7,2,0
601,2019-05-12 02:05:00,13,66.1,3,62.2,16,65.4,2,0
602,2019-05-12 02:10:00,13,66.5,3,62.4,16,65.7,2,0
603,2019-05-12 02:15:00,13,66.4,3,62.3,16,65.6,2,0
604,2019-05-12 02:20:00,1,70.7,5,62.4,6,63.8,2,0
605,2019-05-12 02:25:00,13,66.6,3,62.4,16,65.8,2,0
606,2019-05-12 02:30:00,13,66.6,3,62.4,16,65.8,2,0
607,2019-05-12 02:35:00,13,66.2,3,62.2,16,65.5,2,0
608,2019-05-12 02:40:00,13,66.4,3,62.3,16,65.6,2,0
609,2019-05-12 02:45:00,12,66.1,2,62.2,14,65.5,2,0
610,2019-05-12 02:50:00,14,66.4,4,62.3,18,65.5,2,0
611,2019-05-12 02:55:00,13,66.1,3,62.2,16,65.3,2,0
612,2019-05-12 03:00:00,12,66.2,2,62.2,14,65.6,2,0
613,2019-05-12 03:05:00,13,66.3,3,62.3,16,65.5,2,0
614,2019-05-12 03:10:00,12,66.4,2,62.3,14,65.8,2,0
615,2019-05-12 03:15:00,3,70.7,6,62.3,9,65.1,2,0
616,2019-05-12 03:20:00,1,70.6,5,62.1,6,63.5,2,0
617,2019-05-12 03:25:00,13,65.5,3,61.9,16,64.8,2,0
618,2019-05-12 03:30:00,13,65.8,3,62.1,16,65.1,2,0
619,2019-05-12 03:35:00,10,66.1,1,62.2,11,65.7,2,0
620,2019-05-12 03:40:00,13,66.3,3,62.3,16,65.5,2,0
621,2019-05-12 03:45:00,10,66.1,1,62.2,11,65.7,2,0
622,2019-05-12 03:50:00,1,70.7,5,62.2,6,63.6,2,0
623,2019-05-12 03:55:00,11,66.3,1,62.3,12,65.9,2,0
624,2019-05-12 04:00:00,13,65.9,3,62.1,16,65.2,2,0
625,2019-05-12 04:05:00,13,65.8,3,62.0,16,65.1,2,0
626,2019-05-12 04:10:00,12,65.9,2,62.1,14,65.4,2,0
627,2019-05-12 04:15:00,14,66.3,4,62.3,18,65.4,2,0
628,2019-05-12 04:20:00,11,66.2,1,62.2,12,65.9,2,0
629,2019-05-12 04:25:00,1,70.6,5,62.1,6,63.5,2,0
630,2019-05-12 04:30:00,11,66.1,1,62.2,12,65.8,2,0
631,2019-05-12 04:35:00,12,65.8,2,62.1,14,65.3,2,0
632,2019-05-12 04:40:00,13,66.1,3,62.2,16,65.3,2,0
633,2019-05-12 04:45:00,1,70.7,5,62.2,6,63.6,2,0
634,2019-05-12 04:50:00,13,66.3,3,62.3,16,65.6,2,0
635,2019-05-12 04:55:00,13,66.3,3,62.3,16,65.6,2,0
636,2019-05-12 05:00:00,3,70.7,6,62.3,9,65.1,2,0
637,2019-05-12 05:05:00,12,66.4,2,62.3,14,65.8,2,0
638,2019-05-12 05:10:00,13,65.5,3,61.9,16,64.8,2,0
639,2019-05-12 05:15:00,2,70.6,5,62.1,7,64.5,2,0
640,2019-05-12 05:20:00,12,66.1,2,62.2,14,65.6,2,0
641,2019-05-12 05:25:00,2,70.6,5,62.1,7,64.5,2,0
642,2019-05-12 05:30:00,14,66.1,4,62.2,18,65.2,2,0
643,2019-05-12 05:35:00,3,70.6,6,61.6,9,64.6,2,0
644,2019-05-12 05:40:00,2,70.6,5,61.8,7,64.3,2,0
645,2019-05-12 05:45:00,13,65.8,3,62.1,16,65.1,2,0
646,2019-05-12 05:50:00,1,70.6,5,62.1,6,63.5,2,0
647,2019-05-12 05:55:00,7,70.7,8,62.3,15,66.2,2,0
648,2019-05-12 06:00:00,14,66.3,4,62.3,18,65.4,2,0
649,2019-05-12 06:05:00,13,66.1,3,62.2,16,65.3,2,0
650,2019-05-12 06:10:00,1,70.6,5,62.1,6,63.5,2,0
651,2019-05-12 06:15:00,5,70.7,8,62.3,13,65.5,2,0
652,2019-05-12 06:20:00,5,70.7,8,62.4,13,65.6,2,0
653,2019-05-12 06:25:00,9,70.7,10,62.4,19,66.3,2,0
654,2019-05-12 06:30:00,13,70.7,13,62.6,26,66.7,2,0
655,2019-05-12 06:35:00,11,70.7,11,62.2,22,66.4,2,0
656,2019-05-12 06:40:00,14,70.6,13,62.1,27,66.5,2,0
657,2019-05-12 06:45:00,11,70.7,11,62.3,22,66.5,2,0
658,2019-05-12 06:50:00,12,70.7,12,62.5,24,66.6,2,0
659,2019-05-12 06:55:00,7,70.6,8,62.0,15,66.0,2,0
660,2019-05-12 07:00:00,3,70.7,6,62.2,9,65.0,2,0
661,2019-05-12 07:05:00,5,70.6,8,61.9,13,65.3,2,0
662,2019-05-12 07:10:00,10,70.6,10,61.9,20,66.3,2,0
663,2019-05-12 07:15:00,12,70.6,12,62.0,24,66.3,2,0
664,2019-05-12 07:20:00,10,70.6,10,62.1,20,66.4,2,0
665,2019-05-12 07:25:00,7,70.6,8,62.1,15,66.1,2,0
666,2019-05-12 07:30:00,5,70.6,8,62.0,13,65.3,2,0
667,2019-05-12 07:35:00,16,70.6,14,62.0,30,66.6,2,0
668,2019-05-12 07:40:00,20,70.7,17,62.5,37,66.9,2,0
669,2019-05-12 07:45:00,17,70.7,15,62.5,32,66.9,2,0
670,2019-05-12 07:50:00,17,70.7,15,62.2,32,66.7,2,0
671,2019-05-12 07:55:00,13,70.6,13,62.2,26,66.4,2,0
672,2019-05-12 08:00:00,9,70.7,10,62.2,19,66.2,2,0
673,2019-05-12 08:05:00,12,70.6,12,61.7,24,66.1,2,0
674,2019-05-12 08:10:00,7,70.6,8,61.8,15,65.9,2,0
675,2019-05-12 08:15:00,20,70.6,17,61.9,37,66.6,2,0
676,2019-05-12 08:20:00,18,70.6,15,62.1,33,66.7,2,0
677,2019-05-12 08:25:00,28,70.7,22,62.4,50,67.0,2,0
678,2019-05-12 08:30:00,22,70.7,18,62.5,40,67.0,2,0
679,2019-05-12 08:35:00,22,70.7,18,62.6,40,67.1,2,0
680,2019-05-12 08:40:00,26,70.7,20,62.7,46,67.3,2,0
681,2019-05-12 08:45:00,28,70.8,22,62.8,50,67.3,2,0
682,2019-05-12 08:50:00,29,70.7,22,62.7,51,67.3,2,0
683,2019-05-12 08:55:00,34,70.7,25,62.7,59,67.4,2,0
684,2019-05-12 09:00:00,19,70.6,16,61.9,35,66.6,2,0
685,2019-05-12 09:05:00,25,70.6,20,62.1,45,66.8,2,0
686,2019-05-12 09:10:00,25,70.7,20,62.2,45,66.9,2,0
687,2019-05-12 09:15:00,30,70.7,23,62.2,53,67.0,2,0
688,2019-05-12 09:20:00,35,70.7,26,62.6,61,67.3,2,0
689,2019-05-12 09:25:00,18,70.7,15,62.5,33,67.0,2,0
690,2019-05-12 09:30:00,14,70.7,13,62.4,27,66.7,2,0
691,2019-05-12 09:35:00,37,70.7,27,62.7,64,67.4,2,0
692,2019-05-12 09:40:00,38,70.7,28,62.5,66,67.2,2,0
693,2019-05-12 09:45:00,44,70.6,32,61.7,76,66.8,2,0
694,2019-05-12 09:50:00,48,70.5,34,61.3,82,66.7,2,0
695,2019-05-12 09:55:00,37,70.6,27,61.9,64,66.9,2,0
696,2019-05-12 10:00:00,43,70.7,31,62.3,74,67.2,2,0
697,2019-05-12 10:05:00,44,70.7,32,62.3,76,67.2,2,0
698,2019-05-12 10:10:00,31,70.6,24,61.8,55,66.8,2,0
699,2019-05-12 10:15:00,41,70.7,30,62.4,71,67.2,2,0
700,2019-05-12 10:20:00,53,70.6,37,61.9,90,67.0,2,0
701,2019-05-12 10:25:00,40,70.6,30,61.9,70,66.9,2,0
702,2019-05-12 10:30:00,46,70.6,33,61.7,79,66.9,2,0
703,2019-05-12 10:35:00,53,70.6,37,62.0,90,67.1,2,0
704,2019-05-12 10:40:00,55,70.7,39,62.7,94,67.4,2,0
705,2019-05-12 10:45:00,49,70.6,35,62.1,84,67.1,2,0
706,2019-05-12 10:50:00,64,70.8,44,62.9,108,67.5,2,0
707,2019-05-12 10:55:00,62,70.8,43,62.9,105,67.6,2,0
708,2019-05-12 11:00:00,59,70.7,42,62.8,101,67.4,2,0
709,2019-05-12 11:05:00,59,70.8,42,62.9,101,67.5,2,0
710,2019-05-12 11:10:00,56,70.8,39,63.3,95,67.7,2,0
711,2019-05-12 11:15:00,71,70.6,49,61.8,120,67.0,2,0
712,2019-05-12 11:20:00,46,70.5,33,61.5,79,66.8,2,0
713,2019-05-12 11:25:00,57,70.7,40,62.3,97,67.2,2,0
714,2019-05-12 11:30:00,71,70.7,49,62.4,120,67.3,2,0
715,2019-05-12 11:35:00,58,70.7,41,62.4,99,67.2,2,0
716,2019-05-12 11:40:00,72,70.7,49,62.5,121,67.4,2,0
717,2019-05-12 11:45:00,54,70.4,38,60.9,92,66.5,2,0
718,2019-05-12 11:50:00,52,70.5,37,61.0,89,66.5,2,0
719,2019-05-12 11:55:00,52,70.6,37,61.6,89,66.8,2,0
720,2019-05-12 12:00:00,49,70.6,35,61.7,84,66.9,2,0
721,2019-05-12 12:05:00,64,70.6,44,61.7,108,67.0,2,0
722,2019-05-12 12:10:00,66,70.6,46,62.1,112,67.1,2,0
723,2019-05-12 12:15:00,64,70.7,44,62.4,108,67.3,2,0
724,2019-05-12 12:20:00,49,70.7,35,62.4,84,67.3,2,0
725,2019-05-12 12:25:00,63,70.7,44,62.4,107,67.3,2,0
726,2019-05-12 12:30:00,53,70.7,37,62.5,90,67.4,2,0
727,2019-05-12 12:35:00,67,70.6,46,62.0,113,67.1,2,0
728,2019-05-12 12:40:00,64,70.7,44,62.5,108,67.4,2,0
729,2019-05-12 12:45:00,62,70.7,43,62.5,105,67.3,2,0
730,2019-05-12 12:50:00,62,70.8,43,62.8,105,67.5,2,0
731,2019-05-12 12:55:00,68,70.7,47,62.5,115,67.4,2,0
732,2019-05-12 13:00:00,62,70.7,43,62.4,105,67.3,2,0
733,2019-05-12 13:05:00,61,70.6,42,61.9,103,67.1,2,0
734,2019-05-12 13:10:00,64,70.7,44,62.5,108,67.4,2,0
735,2019-05-12 13:15:00,58,70.5,41,61.1,99,66.6,2,0
736,2019-05-12 13:20:00,63,70.6,44,61.7,107,66.9,2,0
737,2019-05-12 13:25:00,64,70.6,44,62.1,108,67.2,2,0
738,2019-05-12 13:30:00,64,70.6,44,61.7,108,67.0,2,0
739,2019-05-12 13:35:00,61,70.6,42,61.8,103,67.0,2,0
740,2019-05-12 13:40:00,67,70.7,46,62.2,113,67.2,2,0
741,2019-05-12 13:45:00,81,70.6,55,61.7,136,67.0,2,0
742,2019-05-12 13:50:00,56,70.5,39,61.5,95,66.8,2,0
743,2019-05-12 13:55:00,62,70.5,43,61.3,105,66.7,2,0
744,2019-05-12 14:00:00,62,70.5,43,61.4,105,66.8,2,0
745,2019-05-12 14:05:00,72,70.5,49,61.2,121,66.7,2,0
746,2019-05-12 14:10:00,63,70.7,44,62.2,107,67.2,2,0
747,2019-05-12 14:15:00,61,70.7,42,62.4,103,67.3,2,0
748,2019-05-12 14:20:00,67,70.7,46,62.7,113,67.5,2,0
749,2019-05-12 14:25:00,70,70.8,48,63.1,118,67.6,2,0
750,2019-05-12 14:30:00,82,70.6,56,62.1,138,67.2,2,0
751,2019-05-12 14:35:00,66,70.7,46,62.4,112,67.3,2,0
752,2019-05-12 14:40:00,59,70.6,42,62.1,101,67.1,2,0
753,2019-05-12 14:45:00,70,70.6,48,61.8,118,67.0,2,0
754,2019-05-12 14:50:00,58,70.7,41,62.5,99,67.3,2,0
755,2019-05-12 14:55:00,68,70.7,47,62.7,115,67.5,2,0
756,2019-05-12 15:00:00,48,70.8,34,62.8,82,67.5,2,0
757,2019-05-12 15:05:00,64,70.7,44,62.3,108,67.2,2,0
758,2019-05-12 15:10:00,62,70.7,43,62.4,105,67.3,2,0
759,2019-05-12 15:15:00,65,70.7,45,62.3,110,67.2,2,0
760,2019-05-12 15:20:00,65,70.6,45,61.6,110,66.9,2,0
761,2019-05-12 15:25:00,68,70.6,47,61.8,115,67.0,2,0
762,2019-05-12 15:30:00,67,70.6,46,61.6,113,66.9,2,0
763,2019-05-12 15:35:00,62,70.7,43,62.4,105,67.3,2,0
764,2019-05-12 15:40:00,56,70.7,39,62.6,95,67.4,2,0
765,2019-05-12 15:45:00,73,70.6,50,61.9,123,67.1,2,0
766,2019-05-12 15:50:00,66,70.7,46,62.3,112,67.2,2,0
767,2019-05-12 15:55:00,53,70.7,37,62.5,90,67.4,2,0
768,2019-05-12 16:00:00,61,70.8,42,63.0,103,67.6,2,0
769,2019-05-12 16:05:00,61,70.5,42,61.6,103,66.9,2,0
770,2019-05-12 16:10:00,57,70.5,40,61.4,97,66.8,2,0
771,2019-05-12 16:15:00,71,70.6,49,62.1,120,67.1,2,0
772,2019-05-12 16:20:00,64,70.7,44,62.8,108,67.5,2,0
773,2019-05-12 16:25:00,66,70.7,46,62.3,112,67.2,2,0
774,2019-05-12 16:30:00,46,70.7,33,62.4,79,67.2,2,0
775,2019-05-12 16:35:00,55,70.7,39,62.3,94,67.2,2,0
776,2019-05-12 16:40:00,50,70.7,36,62.7,86,67.4,2,0
777,2019-05-12 16:45:00,53,70.6,37,61.9,90,67.0,2,0
778,2019-05-12 16:50:00,53,70.7,37,62.3,90,67.2,2,0
779,2019-05-12 16:55:00,63,70.6,44,61.9,107,67.0,2,0
780,2019-05-12 17:00:00,68,70.7,47,62.5,115,67.4,2,0
781,2019-05-12 17:05:00,54,70.6,38,62.2,92,67.1,2,0
782,2019-05-12 17:10:00,66,70.8,46,63.0,112,67.6,2,0
783,2019-05-12 17:15:00,43,70.7,31,62.5,74,67.3,2,0
784,2019-05-12 17:20:00,73,70.7,50,62.7,123,67.5,2,0
785,2019-05-12 17:25:00,55,70.8,39,62.9,94,67.5,2,0
786,2019-05-12 17:30:00,63,70.8,44,63.3,107,67.8,2,0
787,2019-05-12 17:35:00,53,70.7,37,62.8,90,67.5,2,0
788,2019-05-12 17:40:00,63,70.7,44,62.5,107,67.4,2,0
789,2019-05-12 17:45:00,65,70.7,45,62.3,110,67.2,2,0
790,2019-05-12 17:50:00,47,70.7,34,62.6,81,67.3,2,0
791,2019-05-12 17:55:00,50,70.6,36,61.8,86,66.9,2,0
792,2019-05-12 18:00:00,48,70.6,34,62.0,82,67.0,2,0
793,2019-05-12 18:05:00,55,70.8,39,63.1,94,67.6,2,0
794,2019-05-12 18:10:00,47,70.7,34,62.7,81,67.4,2,0
795,2019-05-12 18:15:00,48,70.8,34,63.1,82,67.6,2,0
796,2019-05-12 18:20:00,48,70.8,34,63.0,82,67.6,2,0
797,2019-05-12 18:25:00,45,70.7,32,62.4,77,67.2,2,0
798,2019-05-12 18:30:00,49,70.7,35,62.4,84,67.2,2,0
799,2019-05-12 18:35:00,58,70.6,41,62.1,99,67.1,2,0
800,2019-05-12 18:40:00,37,70.8,27,63.0,64,67.5,2,0
801,2019-05-12 18:45:00,44,70.8,32,62.9,76,67.4,2,0
802,2019-05-12 18:50:00,41,70.7,30,62.3,71,67.1,2,0
803,2019-05-12 18:55:00,41,70.5,30,61.2,71,66.6,2,0
804,2019-05-12 19:00:00,41,70.6,30,62.2,71,67.1,2,0
805,2019-05-12 19:05:00,34,70.7,25,62.4,59,67.2,2,0
806,2019-05-12 19:10:00,57,70.7,40,62.7,97,67.4,2,0
807,2019-05-12 19:15:00,35,70.6,26,62.0,61,67.0,2,0
808,2019-05-12 19:20:00,40,70.6,30,61.9,70,66.9,2,0
809,2019-05-12 19:25:00,32,70.7,25,62.2,57,66.9,2,0
810,2019-05-12 19:30:00,41,70.7,30,62.7,71,67.4,2,0
811,2019-05-12 19:35:00,38,70.8,28,62.8,66,67.4,2,0
812,2019-05-12 19:40:00,38,70.5,28,61.1,66,66.5,2,0
813,2019-05-12 19:45:00,30,70.6,23,61.8,53,66.8,2,0
814,2019-05-12 19:50:00,45,70.4,32,60.7,77,66.3,2,0
815,2019-05-12 19:55:00,45,70.6,32,61.9,77,67.0,2,0
816,2019-05-12 20:00:00,32,70.6,25,61.9,57,66.8,2,0
817,2019-05-12 20:05:00,29,70.7,22,62.4,51,67.1,2,0
818,2019-05-12 20:10:00,38,70.7,28,62.6,66,67.3,2,0
819,2019-05-12 20:15:00,29,70.7,22,62.4,51,67.1,2,0
820,2019-05-12 20:20:00,38,70.5,28,61.0,66,66.5,2,0
821,2019-05-12 20:25:00,35,70.5,26,61.5,61,66.7,2,0
822,2019-05-12 20:30:00,37,70.7,27,62.2,64,67.1,2,0
823,2019-05-12 20:35:00,27,70.6,21,61.9,48,66.8,2,0
824,2019-05-12 20:40:00,27,70.6,21,61.7,48,66.7,2,0
825,2019-05-12 20:45:00,23,70.4,19,60.9,42,66.1,2,0
826,2019-05-12 20:50:00,26,70.6,20,61.6,46,66.7,2,0
827,2019-05-12 20:55:00,20,70.6,17,61.8,37,66.6,2,0
828,2019-05-12 21:00:00,32,70.7,25,62.3,57,67.0,2,0
829,2019-05-12 21:05:00,22,70.6,18,61.9,40,66.7,2,0
830,2019-05-12 21:10:00,27,70.7,21,62.3,48,67.0,2,0
831,2019-05-12 21:15:00,21,70.7,17,62.5,38,67.1,2,0
832,2019-05-12 21:20:00,32,70.7,25,62.4,57,67.1,2,0
833,2019-05-12 21:25:00,26,70.6,20,62.0,46,66.9,2,0
834,2019-05-12 21:30:00,20,70.7,17,62.3,37,66.8,2,0
835,2019-05-12 21:35:00,26,70.5,20,61.2,46,66.4,2,0
836,2019-05-12 21:40:00,27,70.5,21,61.3,48,66.5,2,0
837,2019-05-12 21:45:00,18,70.6,15,61.9,33,66.6,2,0
838,2019-05-12 21:50:00,21,70.6,17,62.0,38,66.8,2,0
839,2019-05-12 21:55:00,20,70.6,17,62.1,37,66.7,2,0
840,2019-05-12 22:00:00,16,70.7,14,62.2,30,66.7,2,0
841,2019-05-12 22:05:00,11,70.7,11,62.4,22,66.5,2,0
842,2019-05-12 22:10:00,17,70.6,15,62.0,32,66.6,2,0
843,2019-05-12 22:15:00,18,70.5,15,61.3,33,66.3,2,0
844,2019-05-12 22:20:00,16,70.4,14,60.7,30,65.9,2,0
845,2019-05-12 22:25:00,23,70.4,19,60.6,42,65.9,2,0
846,2019-05-12 22:30:00,11,70.5,11,61.3,22,65.9,2,0
847,2019-05-12 22:35:00,8,70.5,9,61.5,17,65.7,2,0
848,2019-05-12 22:40:00,11,70.6,11,61.9,22,66.3,2,0
849,2019-05-12 22:45:00,8,70.6,9,62.1,17,66.1,2,0
850,2019-05-12 22:50:00,8,70.6,9,62.1,17,66.1,2,0
851,2019-05-12 22:55:00,7,70.7,8,62.2,15,66.1,2,0
852,2019-05-12 23:00:00,10,70.6,10,62.2,20,66.4,2,0
853,2019-05-12 23:05:00,10,70.6,10,61.8,20,66.2,2,0
854,2019-05-12 23:10:00,10,70.6,10,61.8,20,66.2,2,0
855,2019-05-12 23:15:00,1,70.6,5,62.2,6,63.6,2,0
856,2019-05-12 23:20:00,7,70.6,8,62.2,15,66.1,2,0
857,2019-05-12 23:25:00,9,70.7,10,62.3,19,66.3,2,0
858,2019-05-12 23:30:00,7,70.7,8,62.4,15,66.3,2,0
859,2019-05-12 23:35:00,3,70.6,6,62.2,9,65.0,2,0
860,2019-05-12 23:40:00,3,70.7,6,62.3,9,65.1,2,0
861,2019-05-12 23:45:00,7,70.6,8,62.1,15,66.1,2,0
862,2019-05-12 23:50:00,3,70.6,6,62.1,9,64.9,2,0
863,2019-05-12 23:55:00,5,70.6,8,62.1,13,65.4,2,0
864,2019-05-13 00:00:00,14,66.2,4,62.2,18,65.3,2,0
865,2019-05-13 00:05:00,9,70.7,10,62.3,19,66.2,2,0
866,2019-05-13 00:10:00,2,70.7,5,62.4,7,64.7,2,0
867,2019-05-13 00:15:00,2,70.6,5,61.9,7,64.4,2,0
868,2019-05-13 00:20:00,10,70.6,10,62.2,20,66.4,2,0
869,2019-05-13 00:25:00,2,70.6,5,61.8,7,64.3,2,0
870,2019-05-13 00:30:00,13,65.6,3,61.9,16,64.9,2,0
871,2019-05-13 00:35:00,12,65.6,2,62.0,14,65.1,2,0
872,2019-05-13 00:40:00,12,66.0,2,62.1,14,65.4,2,0
873,2019-05-13 00:45:00,10,66.2,1,62.2,11,65.8,2,0
874,2019-05-13 00:50:00,13,66.2,3,62.2,16,65.5,2,0
875,2019-05-13 00:55:00,13,66.3,3,62.3,16,65.6,2,0
876,2019-05-13 01:00:00,14,66.1,4,62.2,18,65.2,2,0
877,2019-05-13 01:05:00,3,70.5,6,61.3,9,64.4,2,0
878,2019-05-13 01:10:00,4,70.5,7,61.5,11,64.8,2,0
879,2019-05-13 01:15:00,14,65.6,4,62.0,18,64.8,2,0
880,2019-05-13 01:20:00,11,65.7,1,62.0,12,65.4,2,0
881,2019-05-13 01:25:00,13,65.9,3,62.1,16,65.2,2,0
882,2019-05-13 01:30:00,3,70.6,6,61.6,9,64.6,2,0
883,2019-05-13 01:35:00,10,64.9,1,61.6,11,64.6,2,0
884,2019-05-13 01:40:00,12,65.0,2,61.7,14,64.5,2,0
885,2019-05-13 01:45:00,13,65.2,3,61.8,16,64.6,2,0
886,2019-05-13 01:50:00,11,65.8,1,62.1,12,65.5,2,0
887,2019-05-13 01:55:00,11,66.2,1,62.2,12,65.9,2,0
888,2019-05-13 02:00:00,10,66.4,1,62.3,11,66.0,2,0
889,2019-05-13 02:05:00,12,66.2,2,62.2,14,65.6,2,0
890,2019-05-13 02:10:00,11,66.5,1,62.4,12,66.1,2,0
891,2019-05-13 02:15:00,10,66.1,1,62.2,11,65.7,2,0
892,2019-05-13 02:20:00,12,66.4,2,62.3,14,65.8,2,0
893,2019-05-13 02:25:00,12,66.2,2,62.2,14,65.6,2,0
894,2019-05-13 02:30:00,11,66.6,1,62.4,12,66.2,2,0
895,2019-05-13 02:35:00,13,65.9,3,62.1,16,65.2,2,0
896,2019-05-13 02:40:00,11,65.8,1,62.1,12,65.5,2,0
897,2019-05-13 02:45:00,13,66.2,3,62.2,16,65.5,2,0
898,2019-05-13 02:50:00,12,66.2,2,62.2,14,65.6,2,0
899,2019-05-13 02:55:00,12,65.9,2,62.1,14,65.4,2,0
900,2019-05-13 03:00:00,13,65.9,3,62.1,16,65.2,2,0
901,2019-05-13 03:05:00,13,66.3,3,62.3,16,65.6,2,0
902,2019-05-13 03:10:00,12,66.2,2,62.2,14,65.6,2,0
903,2019-05-13 03:15:00,13,66.5,3,62.4,16,65.7,2,0
904,2019-05-13 03:20:00,12,66.1,2,62.2,14,65.6,2,0
905,2019-05-13 03:25:00,13,65.7,3,62.0,16,65.0,2,0
906,2019-05-13 03:30:00,13,64.4,3,61.4,16,63.9,2,0
907,2019-05-13 03:35:00,13,65.2,3,61.8,16,64.6,2,0
908,2019-05-13 03:40:00,13,65.4,3,61.9,16,64.8,2,0
909,2019-05-13 03:45:00,12,65.7,2,62.0,14,65.2,2,0
910,2019-05-13 03:50:00,13,66.2,3,62.2,16,65.5,2,0
911,2019-05-13 03:55:00,13,65.8,3,62.0,16,65.1,2,0
912,2019-05-13 04:00:00,12,65.8,2,62.0,14,65.2,2,0
913,2019-05-13 04:05:00,13,66.3,3,62.3,16,65.5,2,0
914,2019-05-13 04:10:00,13,66.3,3,62.3,16,65.5,2,0
915,2019-05-13 04:15:00,1,70.7,5,62.3,6,63.7,2,0
916,2019-05-13 04:20:00,1,70.7,5,62.2,6,63.6,2,0
917,2019-05-13 04:25:00,11,66.4,1,62.3,12,66.1,2,0
918,2019-05-13 04:30:00,5,70.5,8,61.2,13,64.8,2,0
919,2019-05-13 04:35:00,2,70.6,5,61.9,7,64.4,2,0
920,2019-05-13 04:40:00,2,70.7,5,62.3,7,64.7,2,0
921,2019-05-13 04:45:00,10,70.7,10,62.5,20,66.6,2,0
922,2019-05-13 04:50:00,8,70.7,9,62.5,17,66.3,2,0
923,2019-05-13 04:55:00,7,70.7,8,62.6,15,66.4,2,0
924,2019-05-13 05:00:00,5,70.6,8,62.2,13,65.4,2,0
925,2019-05-13 05:05:00,11,70.6,11,62.1,22,66.4,2,0
926,2019-05-13 05:10:00,4,70.7,7,62.3,11,65.3,2,0
927,2019-05-13 05:15:00,7,70.5,8,61.4,15,65.6,2,0
928,2019-05-13 05:20:00,22,70.4,18,60.5,40,65.9,2,0
929,2019-05-13 05:25:00,18,70.6,15,61.6,33,66.5,2,0
930,2019-05-13 05:30:00,17,70.5,15,61.3,32,66.2,2,0
931,2019-05-13 05:35:00,19,70.6,16,61.9,35,66.6,2,0
932,2019-05-13 05:40:00,22,70.6,18,61.9,40,66.7,2,0
933,2019-05-13 05:45:00,20,70.7,17,62.5,37,67.0,2,0
934,2019-05-13 05:50:00,29,70.8,22,62.8,51,67.3,2,0
935,2019-05-13 05:55:00,23,70.7,19,62.6,42,67.0,2,0
936,2019-05-13 06:00:00,23,70.6,19,61.8,42,66.6,2,0
937,2019-05-13 06:05:00,20,70.5,17,61.5,37,66.4,2,0
938,2019-05-13 06:10:00,38,70.7,28,62.7,66,67.3,2,0
939,2019-05-13 06:15:00,31,70.6,24,61.9,55,66.8,2,0
940,2019-05-13 06:20:00,38,70.7,28,62.6,66,67.3,2,0
941,2019-05-13 06:25:00,43,70.7,31,62.3,74,67.1,2,0
942,2019-05-13 06:30:00,37,70.6,27,61.9,64,66.9,2,0
943,2019-05-13 06:35:00,35,70.9,26,63.4,61,67.7,2,0
944,2019-05-13 06:40:00,47,70.6,34,61.6,81,66.8,2,0
945,2019-05-13 06:45:00,46,70.5,33,61.1,79,66.6,2,0
946,2019-05-13 06:50:00,53,70.5,37,61.0,90,66.6,2,0
947,2019-05-13 06:55:00,48,70.2,34,59.5,82,65.8,2,0
948,2019-05-13 07:00:00,55,70.2,39,59.4,94,65.7,2,0
949,2019-05-13 07:05:00,70,70.3,48,60.0,118,66.1,2,0
950,2019-05-13 07:10:00,48,70.0,34,58.5,82,65.2,2,0
951,2019-05-13 07:15:00,72,70.1,49,58.7,121,65.5,2,0
952,2019-05-13 07:20:00,66,70.0,46,58.4,112,65.2,2,0
953,2019-05-13 07:25:00,65,70.0,45,58.5,110,65.3,2,0
954,2019-05-13 07:30:00,71,69.8,49,57.1,120,64.6,2,0
955,2019-05-13 07:35:00,74,69.8,51,57.4,125,64.8,2,0
956,2019-05-13 07:40:00,68,70.1,47,58.9,115,65.5,2,0
957,2019-05-13 07:45:00,72,70.0,49,58.2,121,65.2,2,0
958,2019-05-13 07:50:00,77,70.0,53,58.5,130,65.3,2,0
959,2019-05-13 07:55:00,80,70.1,54,59.0,134,65.7,2,0
960,2019-05-13 08:00:00,76,70.0,52,58.3,128,65.2,2,0
961,2019-05-13 08:05:00,63,70.2,44,59.4,107,65.7,2,0
962,2019-05-13 08:10:00,62,70.1,43,59.0,105,65.6,2,0
963,2019-05-13 08:15:00,65,70.3,45,60.0,110,66.1,2,0
964,2019-05-13 08:20:00,66,70.1,46,59.1,112,65.6,2,0
965,2019-05-13 08:25:00,71,70.2,49,59.3,120,65.7,2,0
966,2019-05-13 08:30:00,55,70.0,39,58.5,94,65.2,2,0
967,2019-05-13 08:35:00,75,70.1,51,59.2,126,65.7,2,0
968,2019-05-13 08:40:00,44,70.0,32,58.6,76,65.2,2,0
969,2019-05-13 08:45:00,61,70.2,42,59.5,103,65.9,2,0
970,2019-05-13 08:50:00,68,70.3,47,60.1,115,66.1,2,0
971,2019-05-13 08:55:00,53,70.4,37,61.0,90,66.6,2,0
972,2019-05-13 09:00:00,45,70.5,32,61.2,77,66.6,2,0
973,2019-05-13 09:05:00,54,70.6,38,61.8,92,67.0,2,0
974,2019-05-13 09:10:00,57,70.7,40,62.4,97,67.2,2,0
975,2019-05-13 09:15:00,49,70.9,35,63.6,84,67.9,2,0
976,2019-05-13 09:20:00,52,70.6,37,61.6,89,66.8,2,0
977,2019-05-13 09:25:00,57,70.6,40,61.7,97,66.9,2,0
978,2019-05-13 09:30:00,45,70.5,32,61.2,77,66.6,2,0
979,2019-05-13 09:35:00,45,70.6,32,61.9,77,67.0,2,0
980,2019-05-13 09:40:00,41,70.1,30,58.7,71,65.3,2,0
981,2019-05-13 09:45:00,55,70.1,39,58.9,94,65.5,2,0
982,2019-05-13 09:50:00,47,70.1,34,59.0,81,65.5,2,0
983,2019-05-13 09:55:00,53,70.4,37,60.9,90,66.5,2,0
984,2019-05-13 10:00:00,50,70.6,36,62.1,86,67.1,2,0
985,2019-05-13 10:05:00,44,70.3,32,60.1,76,66.0,2,0
986,2019-05-13 10:10:00,31,70.4,24,60.4,55,66.0,2,0
987,2019-05-13 10:15:00,35,70.1,26,58.8,61,65.3,2,0
988,2019-05-13 10:20:00,46,70.2,33,59.3,79,65.6,2,0
989,2019-05-13 10:25:00,46,70.1,33,59.2,79,65.6,2,0
990,2019-05-13 10:30:00,55,70.2,39,59.7,94,65.9,2,0
991,2019-05-13 10:35:00,44,70.5,32,61.4,76,66.7,2,0
992,2019-05-13 10:40:00,45,70.4,32,60.8,77,66.4,2,0
993,2019-05-13 10:45:00,40,70.3,30,60.2,70,66.0,2,0
994,2019-05-13 10:50:00,41,70.2,30,59.5,71,65.7,2,0
995,2019-05-13 10:55:00,54,70.3,38,59.8,92,65.9,2,0
996,2019-05-13 11:00:00,44,70.3,32,60.0,76,65.9,2,0
997,2019-05-13 11:05:00,35,70.4,26,61.0,61,66.4,2,0
998,2019-05-13 11:10:00,39,70.6,29,61.7,68,66.8,2,0
999,2019-05-13 11:15:00,47,70.7,34,62.4,81,67.2,2,0
1000,2019-05-13 11:20:00,44,70.7,32,62.7,76,67.4,2,0
1001,2019-05-13 11:25:00,52,70.5,37,61.5,89,66.8,2,0
1002,2019-05-13 11:30:00,56,70.7,39,62.2,95,67.2,2,0
1003,2019-05-13 11:35:00,40,70.6,30,61.9,70,66.9,2,0
1004,2019-05-13 11:40:00,45,70.6,32,62.2,77,67.1,2,0
1005,2019-05-13 11:45:00,50,70.8,36,62.8,86,67.4,2,0
1006,2019-05-13 11:50:00,39,70.5,29,61.4,68,66.6,2,0
1007,2019-05-13 11:55:00,40,70.8,30,62.8,70,67.3,2,0
1008,2019-05-13 12:00:00,41,70.7,30,62.4,71,67.2,2,0
1009,2019-05-13 12:05:00,48,70.7,34,62.4,82,67.2,2,0
1010,2019-05-13 12:10:00,43,70.6,31,62.1,74,67.0,2,0
1011,2019-05-13 12:15:00,50,70.5,36,61.4,86,66.7,2,0
1012,2019-05-13 12:20:00,50,70.5,36,61.3,86,66.6,2,0
1013,2019-05-13 12:25:00,47,70.4,34,61.0,81,66.5,2,0
1014,2019-05-13 12:30:00,55,70.8,39,62.9,94,67.5,2,0
1015,2019-05-13 12:35:00,52,70.2,37,59.8,89,65.9,2,0
1016,2019-05-13 12:40:00,54,70.4,38,60.9,92,66.5,2,0
1017,2019-05-13 12:45:00,49,70.5,35,61.3,84,66.7,2,0
1018,2019-05-13 12:50:00,37,70.6,27,61.8,64,66.9,2,0
1019,2019-05-13 12:55:00,55,70.2,39,59.5,94,65.7,2,0
1020,2019-05-13 13:00:00,54,70.2,38,59.3,92,65.7,2,0
1021,2019-05-13 13:05:00,54,70.3,38,60.3,92,66.2,2,0
1022,2019-05-13 13:10:00,41,70.3,30,59.9,71,65.9,2,0
1023,2019-05-13 13:15:00,47,70.4,34,60.6,81,66.3,2,0
1024,2019-05-13 13:20:00,47,70.3,34,60.1,81,66.0,2,0
1025,2019-05-13 13:25:00,54,70.5,38,61.3,92,66.7,2,0
1026,2019-05-13 13:30:00,53,70.5,37,61.3,90,66.7,2,0
1027,2019-05-13 13:35:00,55,70.5,39,61.2,94,66.7,2,0
1028,2019-05-13 13:40:00,62,70.4,43,60.8,105,66.5,2,0
1029,2019-05-13 13:45:00,56,70.6,39,61.7,95,67.0,2,0
1030,2019-05-13 13:50:00,50,70.4,36,60.8,86,66.4,2,0
1031,2019-05-13 13:55:00,62,70.4,43,60.5,105,66.3,2,0
1032,2019-05-13 14:00:00,44,70.0,32,58.4,76,65.1,2,0
1033,2019-05-13 14:05:00,53,69.9,37,57.9,90,65.0,2,0
1034,2019-05-13 14:10:00,67,70.0,46,58.1,113,65.1,2,0
1035,2019-05-13 14:15:00,66,69.8,46,57.0,112,64.5,2,0
1036,2019-05-13 14:20:00,44,69.6,32,56.0,76,63.9,2,0
1037,2019-05-13 14:25:00,68,69.8,47,57.0,115,64.5,2,0
1038,2019-05-13 14:30:00,67,69.9,46,57.5,113,64.8,2,0
1039,2019-05-13 14:35:00,65,70.1,45,58.7,110,65.4,2,0
1040,2019-05-13 14:40:00,64,70.1,44,58.8,108,65.5,2,0
1041,2019-05-13 14:45:00,67,69.9,46,57.7,113,64.9,2,0
1042,2019-05-13 14:50:00,56,69.8,39,57.4,95,64.7,2,0
1043,2019-05-13 14:55:00,72,70.0,49,58.0,121,65.1,2,0
1044,2019-05-13 15:00:00,91,70.0,61,58.6,152,65.5,2,0
1045,2019-05-13 15:05:00,54,70.1,38,58.7,92,65.4,2,0
1046,2019-05-13 15:10:00,61,70.0,42,58.2,103,65.2,2,0
1047,2019-05-13 15:15:00,77,70.1,53,59.0,130,65.6,2,0
1048,2019-05-13 15:20:00,73,70.1,50,59.1,123,65.6,2,0
1049,2019-05-13 15:25:00,63,70.1,44,58.7,107,65.4,2,0
1050,2019-05-13 15:30:00,53,70.0,37,58.5,90,65.3,2,0
1051,2019-05-13 15:35:00,62,70.0,43,58.1,105,65.1,2,0
1052,2019-05-13 15:40:00,56,69.9,39,58.0,95,65.0,2,0
1053,2019-05-13 15:45:00,65,70.0,45,58.0,110,65.1,2,0
1054,2019-05-13 15:50:00,62,70.1,43,59.1,105,65.6,2,0
1055,2019-05-13 15:55:00,72,70.2,49,59.5,121,65.9,2,0
1056,2019-05-13 16:00:00,67,70.2,46,59.5,113,65.8,2,0
1057,2019-05-13 16:05:00,57,70.2,40,59.3,97,65.7,2,0
1058,2019-05-13 16:10:00,68,70.3,47,60.0,115,66.1,2,0
1059,2019-05-13 16:15:00,65,70.3,45,59.9,110,66.0,2,0
1060,2019-05-13 16:20:00,54,70.6,38,61.6,92,66.8,2,0
1061,2019-05-13 16:25:00,53,70.4,37,60.9,90,66.5,2,0
1062,2019-05-13 16:30:00,61,70.3,42,60.3,103,66.2,2,0
1063,2019-05-13 16:35:00,77,70.3,53,60.2,130,66.2,2,0
1064,2019-05-13 16:40:00,74,70.5,51,61.0,125,66.6,2,0
1065,2019-05-13 16:45:00,77,70.5,53,61.2,130,66.7,2,0
1066,2019-05-13 16:50:00,63,70.6,44,61.7,107,66.9,2,0
1067,2019-05-13 16:55:00,66,70.5,46,61.0,112,66.6,2,0
1068,2019-05-13 17:00:00,70,70.5,48,61.4,118,66.8,2,0
1069,2019-05-13 17:05:00,68,70.5,47,61.0,115,66.6,2,0
1070,2019-05-13 17:10:00,52,70.4,37,60.9,89,66.4,2,0
1071,2019-05-13 17:15:00,83,70.5,56,61.2,139,66.7,2,0
1072,2019-05-13 17:20:00,71,70.5,49,61.2,120,66.7,2,0
1073,2019-05-13 17:25:00,68,70.5,47,61.3,115,66.7,2,0
1074,2019-05-13 17:30:00,61,70.3,42,60.1,103,66.1,2,0
1075,2019-05-13 17:35:00,73,70.4,50,60.6,123,66.4,2,0
1076,2019-05-13 17:40:00,58,70.5,41,61.1,99,66.6,2,0
1077,2019-05-13 17:45:00,64,70.4,44,60.4,108,66.3,2,0
1078,2019-05-13 17:50:00,73,70.3,50,59.9,123,66.0,2,0
1079,2019-05-13 17:55:00,61,70.3,42,60.2,103,66.2,2,0
1080,2019-05-13 18:00:00,71,70.6,49,61.8,120,67.0,2,0
1081,2019-05-13 18:05:00,58,70.8,41,62.8,99,67.5,2,0
1082,2019-05-13 18:10:00,59,70.9,42,63.6,101,67.9,2,0
1083,2019-05-13 18:15:00,53,70.7,37,62.6,90,67.4,2,0
1084,2019-05-13 18:20:00,55,70.5,39,61.4,94,66.7,2,0
1085,2019-05-13 18:25:00,55,70.6,39,62.1,94,67.1,2,0
1086,2019-05-13 18:30:00,55,70.8,39,62.8,94,67.5,2,0
1087,2019-05-13 18:35:00,48,70.6,34,61.7,82,66.9,2,0
1088,2019-05-13 18:40:00,40,70.4,30,60.7,70,66.3,2,0
1089,2019-05-13 18:45:00,53,70.4,37,61.0,90,66.6,2,0
1090,2019-05-13 18:50:00,39,70.6,29,61.6,68,66.8,2,0
1091,2019-05-13 18:55:00,43,70.5,31,61.0,74,66.5,2,0
1092,2019-05-13 19:00:00,47,70.6,34,61.7,81,66.9,2,0
1093,2019-05-13 19:05:00,44,70.4,32,60.8,76,66.4,2,0
1094,2019-05-13 19:10:00,50,70.6,36,61.6,86,66.8,2,0
1095,2019-05-13 19:15:00,50,70.7,36,62.4,86,67.2,2,0
1096,2019-05-13 19:20:00,44,70.5,32,61.0,76,66.5,2,0
1097,2019-05-13 19:25:00,40,70.5,30,61.2,70,66.5,2,0
1098,2019-05-13 19:30:00,30,70.4,23,60.8,53,66.2,2,0
1099,2019-05-13 19:35:00,43,70.6,31,62.2,74,67.1,2,0
1100,2019-05-13 19:40:00,21,70.7,17,62.4,38,67.0,2,0
1101,2019-05-13 19:45:00,37,70.7,27,62.7,64,67.3,2,0
1102,2019-05-13 19:50:00,25,70.7,20,62.5,45,67.1,2,0
1103,2019-05-13 19:55:00,31,70.7,24,62.4,55,67.1,2,0
1104,2019-05-13 20:00:00,34,70.7,25,62.8,59,67.4,2,0
1105,2019-05-13 20:05:00,27,70.8,21,63.1,48,67.5,2,0
1106,2019-05-13 20:10:00,20,70.8,17,62.9,37,67.2,2,0
1107,2019-05-13 20:15:00,30,70.6,23,61.9,53,66.8,2,0
1108,2019-05-13 20:20:00,27,70.7,21,62.2,48,67.0,2,0
1109,2019-05-13 20:25:00,26,70.7,20,62.4,46,67.1,2,0
1110,2019-05-13 20:30:00,19,70.7,16,62.6,35,67.0,2,0
1111,2019-05-13 20:35:00,19,70.2,16,59.4,35,65.3,2,0
1112,2019-05-13 20:40:00,21,70.4,17,60.9,38,66.1,2,0
1113,2019-05-13 20:45:00,17,70.5,15,61.4,32,66.2,2,0
1114,2019-05-13 20:50:00,23,70.6,19,61.8,42,66.6,2,0
1115,2019-05-13 20:55:00,21,70.7,17,62.3,38,66.9,2,0
1116,2019-05-13 21:00:00,23,70.7,19,62.5,42,67.0,2,0
1117,2019-05-13 21:05:00,20,70.5,17,61.2,37,66.2,2,0
1118,2019-05-13 21:10:00,20,70.6,17,62.1,37,66.7,2,0
1119,2019-05-13 21:15:00,17,70.5,15,61.6,32,66.3,2,0
1120,2019-05-13 21:20:00,21,70.6,17,61.9,38,66.7,2,0
1121,2019-05-13 21:25:00,31,70.6,24,61.9,55,66.8,2,0
1122,2019-05-13 21:30:00,13,70.7,13,62.3,26,66.5,2,0
1123,2019-05-13 21:35:00,20,70.7,17,62.6,37,67.0,2,0
1124,2019-05-13 21:40:00,22,70.6,18,62.0,40,66.7,2,0
1125,2019-05-13 21:45:00,12,70.6,12,61.9,24,66.3,2,0
1126,2019-05-13 21:50:00,14,70.7,13,62.3,27,66.7,2,0
1127,2019-05-13 21:55:00,13,70.7,13,62.3,26,66.5,2,0
1128,2019-05-13 22:00:00,11,70.7,11,62.2,22,66.4,2,0
1129,2019-05-13 22:05:00,7,70.6,8,61.9,15,66.0,2,0
1130,2019-05-13 22:10:00,9,70.6,10,61.9,19,66.0,2,0
1131,2019-05-13 22:15:00,10,70.6,10,62.1,20,66.4,2,0
1132,2019-05-13 22:20:00,9,70.7,10,62.4,19,66.3,2,0
1133,2019-05-13 22:25:00,14,70.5,13,61.2,27,66.0,2,0
1134,2019-05-13 22:30:00,9,70.6,10,61.9,19,66.0,2,0
1135,2019-05-13 22:35:00,11,70.5,11,61.0,22,65.8,2,0
1136,2019-05-13 22:40:00,9,70.6,10,61.7,19,65.9,2,0
1137,2019-05-13 22:45:00,13,70.6,13,61.6,26,66.1,2,0
1138,2019-05-13 22:50:00,13,70.5,13,61.3,26,65.9,2,0
1139,2019-05-13 22:55:00,4,70.6,7,61.9,11,65.0,2,0
1140,2019-05-13 23:00:00,9,70.6,10,62.0,19,66.1,2,0
1141,2019-05-13 23:05:00,3,70.7,6,62.3,9,65.1,2,0
1142,2019-05-13 23:10:00,4,70.6,7,61.8,11,65.0,2,0
1143,2019-05-13 23:15:00,9,70.6,10,62.1,19,66.1,2,0
1144,2019-05-13 23:20:00,7,70.6,8,61.8,15,65.9,2,0
1145,2019-05-13 23:25:00,2,70.6,5,62.2,7,64.6,2,0
1146,2019-05-13 23:30:00,5,70.7,8,62.3,13,65.5,2,0
1147,2019-05-13 23:35:00,13,66.5,3,62.4,16,65.7,2,0
1148,2019-05-13 23:40:00,5,70.7,8,62.5,13,65.6,2,0
1149,2019-05-13 23:45:00,12,70.6,12,62.1,24,66.4,2,0
1150,2019-05-13 23:50:00,13,66.3,3,62.3,16,65.5,2,0
1151,2019-05-13 23:55:00,13,66.4,3,62.3,16,65.6,2,0
1152,2019-05-14 00:00:00,4,70.7,7,62.2,11,65.3,2,0
1153,2019-05-14 00:05:00,14,66.5,4,62.4,18,65.6,2,0
1154,2019-05-14 00:10:00,1,70.6,5,61.9,6,63.4,2,0
1155,2019-05-14 00:15:00,13,65.8,3,62.1,16,65.1,2,0
1156,2019-05-14 00:20:00,11,70.7,11,62.2,22,66.4,2,0
1157,2019-05-14 00:25:00,13,65.9,3,62.1,16,65.2,2,0
1158,2019-05-14 00:30:00,11,66.2,1,62.2,12,65.9,2,0
1159,2019-05-14 00:35:00,13,66.3,3,62.3,16,65.6,2,0
1160,2019-05-14 00:40:00,10,66.3,1,62.3,11,66.0,2,0
1161,2019-05-14 00:45:00,11,66.4,1,62.3,12,66.1,2,0
1162,2019-05-14 00:50:00,2,70.5,5,61.3,7,63.9,2,0
1163,2019-05-14 00:55:00,13,64.1,3,61.3,16,63.6,2,0
1164,2019-05-14 01:00:00,14,64.0,4,61.2,18,63.4,2,0
1165,2019-05-14 01:05:00,13,65.5,3,61.9,16,64.8,2,0
1166,2019-05-14 01:10:00,13,65.9,3,62.1,16,65.2,2,0
1167,2019-05-14 01:15:00,13,66.1,3,62.2,16,65.4,2,0
1168,2019-05-14 01:20:00,10,66.5,1,62.4,11,66.1,2,0
1169,2019-05-14 01:25:00,14,65.8,4,62.0,18,64.9,2,0
1170,2019-05-14 01:30:00,13,65.6,3,61.9,16,64.9,2,0
1171,2019-05-14 01:35:00,12,65.8,2,62.0,14,65.2,2,0
1172,2019-05-14 01:40:00,13,66.3,3,62.3,16,65.6,2,0
1173,2019-05-14 01:45:00,12,66.1,2,62.2,14,65.6,2,0
1174,2019-05-14 01:50:00,3,70.7,6,62.5,9,65.3,2,0
1175,2019-05-14 01:55:00,12,66.5,2,62.4,14,65.9,2,0
1176,2019-05-14 02:00:00,13,66.9,3,62.5,16,66.1,2,0
1177,2019-05-14 02:05:00,9,66.8,29,63.0,38,63.9,2,0
1178,2019-05-14 02:10:00,11,65.6,1,61.9,12,65.3,2,0
1179,2019-05-14 02:15:00,10,66.1,1,62.2,11,65.8,2,0
1180,2019-05-14 02:20:00,14,65.8,4,62.1,18,65.0,2,0
1181,2019-05-14 02:25:00,13,66.3,3,62.3,16,65.6,2,0
1182,2019-05-14 02:30:00,11,66.6,1,62.4,12,66.2,2,0
1183,2019-05-14 02:35:00,11,65.8,1,62.0,12,65.5,2,0
1184,2019-05-14 02:40:00,12,66.8,2,62.5,14,66.2,2,0
1185,2019-05-14 02:45:00,13,66.2,3,62.2,16,65.5,2,0
1186,2019-05-14 02:50:00,2,70.7,5,62.2,7,64.6,2,0
1187,2019-05-14 02:55:00,2,70.7,5,62.5,7,64.9,2,0
1188,2019-05-14 03:00:00,10,66.8,1,62.5,11,66.5,2,0
1189,2019-05-14 03:05:00,5,70.7,8,62.8,13,65.8,2,0
1190,2019-05-14 03:10:00,10,66.8,1,62.5,11,66.4,2,0
1191,2019-05-14 03:15:00,13,66.9,3,62.5,16,66.1,2,0
1192,2019-05-14 03:20:00,11,66.4,1,62.3,12,66.1,2,0
1193,2019-05-14 03:25:00,11,65.7,1,62.0,12,65.4,2,0
1194,2019-05-14 03:30:00,9,66.1,29,62.3,38,63.2,2,0
1195,2019-05-14 03:35:00,13,65.6,3,62.0,16,64.9,2,0
1196,2019-05-14 03:40:00,12,65.8,2,62.1,14,65.3,2,0
1197,2019-05-14 03:45:00,12,66.4,2,62.3,14,65.8,2,0
1198,2019-05-14 03:50:00,13,66.1,3,62.2,16,65.4,2,0
1199,2019-05-14 03:55:00,1,70.5,5,61.5,6,63.0,2,0
1200,2019-05-14 04:00:00,13,64.4,3,61.4,16,63.8,2,0
1201,2019-05-14 04:05:00,13,64.4,3,61.4,16,63.9,2,0
1202,2019-05-14 04:10:00,3,70.6,6,61.9,9,64.8,2,0
1203,2019-05-14 04:15:00,4,70.6,7,61.8,11,65.0,2,0
1204,2019-05-14 04:20:00,2,70.6,5,62.0,7,64.5,2,0
1205,2019-05-14 04:25:00,13,65.6,3,61.9,16,64.9,2,0
1206,2019-05-14 04:30:00,14,65.9,4,62.1,18,65.1,2,0
1207,2019-05-14 04:35:00,14,65.6,4,62.0,18,64.8,2,0
1208,2019-05-14 04:40:00,8,70.7,9,62.4,17,66.3,2,0
1209,2019-05-14 04:45:00,8,70.7,9,62.6,17,66.4,2,0
1210,2019-05-14 04:50:00,12,70.7,12,62.6,24,66.7,2,0
1211,2019-05-14 04:55:00,11,70.7,11,62.3,22,66.5,2,0
1212,2019-05-14 05:00:00,12,70.7,12,62.6,24,66.6,2,0
1213,2019-05-14 05:05:00,2,70.7,5,62.2,7,64.6,2,0
1214,2019-05-14 05:10:00,17,70.4,15,60.7,32,65.8,2,0
1215,2019-05-14 05:15:00,18,70.6,15,61.8,33,66.6,2,0
1216,2019-05-14 05:20:00,14,70.7,13,62.4,27,66.7,2,0
1217,2019-05-14 05:25:00,18,70.7,15,62.4,33,66.9,2,0
1218,2019-05-14 05:30:00,21,70.6,17,61.9,38,66.7,2,0
1219,2019-05-14 05:35:00,19,70.6,16,62.0,35,66.7,2,0
1220,2019-05-14 05:40:00,36,70.8,27,63.0,63,67.4,2,0
1221,2019-05-14 05:45:00,20,70.8,17,63.0,37,67.2,2,0
1222,2019-05-14 05:50:00,38,70.8,28,63.0,66,67.5,2,0
1223,2019-05-14 05:55:00,22,70.7,18,62.7,40,67.1,2,0
1224,2019-05-14 06:00:00,37,70.8,27,63.1,64,67.6,2,0
1225,2019-05-14 06:05:00,34,70.7,25,62.2,59,67.1,2,0
1226,2019-05-14 06:10:00,29,70.6,22,61.9,51,66.9,2,0
1227,2019-05-14 06:15:00,34,70.7,25,62.8,59,67.4,2,0
1228,2019-05-14 06:20:00,44,70.7,32,62.3,76,67.1,2,0
1229,2019-05-14 06:25:00,45,70.8,32,63.0,77,67.6,2,0
1230,2019-05-14 06:30:00,38,70.9,28,63.4,66,67.7,2,0
1231,2019-05-14 06:35:00,41,70.7,30,62.2,71,67.1,2,0
1232,2019-05-14 06:40:00,39,70.7,29,62.4,68,67.1,2,0
1233,2019-05-14 06:45:00,64,70.8,44,62.8,108,67.5,2,0
1234,2019-05-14 06:50:00,53,70.5,37,61.3,90,66.7,2,0
1235,2019-05-14 06:55:00,61,70.6,42,62.1,103,67.1,2,0
1236,2019-05-14 07:00:00,64,70.5,44,61.1,108,66.6,2,0
1237,2019-05-14 07:05:00,54,70.3,38,59.9,92,66.0,2,0
1238,2019-05-14 07:10:00,46,70.1,33,59.1,79,65.5,2,0
1239,2019-05-14 07:15:00,68,70.1,47,58.8,115,65.5,2,0
1240,2019-05-14 07:20:00,79,70.0,54,58.1,133,65.2,2,0
1241,2019-05-14 07:25:00,62,69.8,43,57.1,105,64.6,2,0
1242,2019-05-14 07:30:00,73,69.9,50,57.6,123,64.9,2,0
1243,2019-05-14 07:35:00,77,69.9,53,57.7,130,64.9,2,0
1244,2019-05-14 07:40:00,74,69.9,51,57.9,125,65.0,2,0
1245,2019-05-14 07:45:00,84,70.0,57,58.5,141,65.3,2,0
1246,2019-05-14 07:50:00,81,70.4,55,60.6,136,66.4,2,0
1247,2019-05-14 07:55:00,83,70.3,56,59.9,139,66.1,2,0
1248,2019-05-14 08:00:00,79,70.3,54,59.8,133,66.0,2,0
1249,2019-05-14 08:05:00,61,70.3,42,59.9,103,66.1,2,0
1250,2019-05-14 08:10:00,62,70.3,43,60.2,105,66.2,2,0
1251,2019-05-14 08:15:00,64,70.2,44,59.6,108,65.9,2,0
1252,2019-05-14 08:20:00,56,70.3,39,60.0,95,66.0,2,0
1253,2019-05-14 08:25:00,71,70.3,49,60.3,120,66.2,2,0
1254,2019-05-14 08:30:00,52,70.1,37,58.7,89,65.3,2,0
1255,2019-05-14 08:35:00,80,70.3,54,60.2,134,66.2,2,0
1256,2019-05-14 08:40:00,50,70.4,36,60.6,86,66.3,2,0
1257,2019-05-14 08:45:00,66,70.1,46,58.7,112,65.4,2,0
1258,2019-05-14 08:50:00,57,70.3,40,59.9,97,66.0,2,0
1259,2019-05-14 08:55:00,66,70.2,46,59.7,112,65.9,2,0
1260,2019-05-14 09:00:00,59,70.2,42,59.3,101,65.7,2,0
1261,2019-05-14 09:05:00,52,70.3,37,60.3,89,66.2,2,0
1262,2019-05-14 09:10:00,55,70.1,39,59.0,94,65.5,2,0
1263,2019-05-14 09:15:00,56,70.2,39,59.5,95,65.8,2,0
1264,2019-05-14 09:20:00,56,70.0,39,58.3,95,65.2,2,0
1265,2019-05-14 09:25:00,61,70.1,42,58.9,103,65.6,2,0
1266,2019-05-14 09:30:00,49,70.0,35,58.4,84,65.2,2,0
1267,2019-05-14 09:35:00,56,69.8,39,57.1,95,64.6,2,0
1268,2019-05-14 09:40:00,54,69.7,38,56.6,92,64.3,2,0
1269,2019-05-14 09:45:00,49,69.8,35,57.1,84,64.5,2,0
1270,2019-05-14 09:50:00,55,69.8,39,57.1,94,64.5,2,0
1271,2019-05-14 09:55:00,61,70.1,42,58.7,103,65.4,2,0
1272,2019-05-14 10:00:00,32,69.9,25,57.8,57,64.6,2,0
1273,2019-05-14 10:05:00,44,69.9,32,57.8,76,64.8,2,0
1274,2019-05-14 10:10:00,46,70.0,33,58.2,79,65.0,2,0
1275,2019-05-14 10:15:00,47,69.7,34,56.6,81,64.2,2,0
1276,2019-05-14 10:20:00,54,69.8,38,57.1,92,64.6,2,0
1277,2019-05-14 10:25:00,44,70.0,32,58.3,76,65.1,2,0
1278,2019-05-14 10:30:00,46,70.2,33,59.5,79,65.7,2,0
1279,2019-05-14 10:35:00,57,70.0,40,58.2,97,65.1,2,0
1280,2019-05-14 10:40:00,59,69.9,42,58.0,101,65.0,2,0
1281,2019-05-14 10:45:00,41,69.9,30,57.7,71,64.7,2,0
1282,2019-05-14 10:50:00,59,69.9,42,57.5,101,64.7,2,0
1283,2019-05-14 10:55:00,49,69.9,35,57.7,84,64.8,2,0
1284,2019-05-14 11:00:00,37,70.2,27,59.6,64,65.7,2,0
1285,2019-05-14 11:05:00,38,70.3,28,59.8,66,65.8,2,0
1286,2019-05-14 11:10:00,43,70.6,31,61.6,74,66.8,2,0
1287,2019-05-14 11:15:00,34,70.5,25,61.5,59,66.7,2,0
1288,2019-05-14 11:20:00,55,70.7,39,62.4,94,67.2,2,0
1289,2019-05-14 11:25:00,52,70.5,37,61.3,89,66.7,2,0
1290,2019-05-14 11:30:00,55,70.5,39,61.5,94,66.8,2,0
1291,2019-05-14 11:35:00,50,70.4,36,60.5,86,66.2,2,0
1292,2019-05-14 11:40:00,41,70.4,30,60.6,71,66.2,2,0
1293,2019-05-14 11:45:00,47,70.3,34,60.1,81,66.0,2,0
1294,2019-05-14 11:50:00,55,70.5,39,61.4,94,66.7,2,0
1295,2019-05-14 11:55:00,56,70.5,39,61.4,95,66.8,2,0
1296,2019-05-14 12:00:00,41,70.0,30,58.5,71,65.2,2,0
1297,2019-05-14 12:05:00,54,70.0,38,58.6,92,65.3,2,0
1298,2019-05-14 12:10:00,49,69.9,35,57.8,84,64.9,2,0
1299,2019-05-14 12:15:00,41,69.9,30,57.9,71,64.8,2,0
1300,2019-05-14 12:20:00,47,69.9,34,57.8,81,64.8,2,0
1301,2019-05-14 12:25:00,44,70.1,32,59.1,76,65.5,2,0
1302,2019-05-14 12:30:00,50,69.9,36,57.9,86,64.9,2,0
1303,2019-05-14 12:35:00,54,69.9,38,57.6,92,64.8,2,0
1304,2019-05-14 12:40:00,61,69.7,42,56.7,103,64.4,2,0
1305,2019-05-14 12:45:00,54,69.8,38,57.0,92,64.5,2,0
1306,2019-05-14 12:50:00,55,69.9,39,57.4,94,64.7,2,0
1307,2019-05-14 12:55:00,41,69.7,30,56.5,71,64.1,2,0
1308,2019-05-14 13:00:00,56,69.7,39,56.6,95,64.3,2,0
1309,2019-05-14 13:05:00,55,69.7,39,56.7,94,64.3,2,0
1310,2019-05-14 13:10:00,57,69.8,40,57.4,97,64.7,2,0
1311,2019-05-14 13:15:00,48,69.9,34,57.8,82,64.9,2,0
1312,2019-05-14 13:20:00,64,69.9,44,58.0,108,65.1,2,0
1313,2019-05-14 13:25:00,53,70.2,37,59.4,90,65.7,2,0
1314,2019-05-14 13:30:00,62,70.0,43,58.3,105,65.2,2,0
1315,2019-05-14 13:35:00,50,69.9,36,57.5,86,64.7,2,0
1316,2019-05-14 13:40:00,49,69.8,35,57.0,84,64.5,2,0
1317,2019-05-14 13:45:00,57,69.8,40,57.2,97,64.6,2,0
1318,2019-05-14 13:50:00,57,69.8,40,57.2,97,64.6,2,0
1319,2019-05-14 13:55:00,52,69.8,37,57.4,89,64.7,2,0
1320,2019-05-14 14:00:00,65,70.1,45,58.9,110,65.5,2,0
1321,2019-05-14 14:05:00,65,69.8,45,57.2,110,64.6,2,0
1322,2019-05-14 14:10:00,54,69.8,38,57.3,92,64.7,2,0
1323,2019-05-14 14:15:00,57,69.8,40,57.3,97,64.7,2,0
1324,2019-05-14 14:20:00,61,69.9,42,57.9,103,65.0,2,0
1325,2019-05-14 14:25:00,49,69.8,35,57.1,84,64.5,2,0
1326,2019-05-14 14:30:00,65,69.9,45,57.8,110,64.9,2,0
1327,2019-05-14 14:35:00,75,69.8,51,57.4,126,64.8,2,0
1328,2019-05-14 14:40:00,48,70.2,34,59.2,82,65.6,2,0
1329,2019-05-14 14:45:00,93,70.1,63,58.7,156,65.5,2,0
1330,2019-05-14 14:50:00,73,70.1,50,58.7,123,65.5,2,0
1331,2019-05-14 14:55:00,52,70.1,37,58.8,89,65.4,2,0
1332,2019-05-14 15:00:00,73,70.0,50,58.4,123,65.3,2,0
1333,2019-05-14 15:05:00,62,70.2,43,59.2,105,65.7,2,0
1334,2019-05-14 15:10:00,75,70.1,51,58.8,126,65.5,2,0
1335,2019-05-14 15:15:00,75,70.2,51,59.8,126,66.0,2,0
1336,2019-05-14 15:20:00,72,70.3,49,60.0,121,66.1,2,0
1337,2019-05-14 15:25:00,82,70.1,56,58.6,138,65.4,2,0
1338,2019-05-14 15:30:00,66,70.2,46,59.5,112,65.8,2,0
1339,2019-05-14 15:35:00,70,70.1,48,59.0,118,65.6,2,0
1340,2019-05-14 15:40:00,57,69.9,40,58.0,97,65.0,2,0
1341,2019-05-14 15:45:00,86,69.9,59,57.9,145,65.0,2,0
1342,2019-05-14 15:50:00,93,70.2,63,59.3,156,65.8,2,0
1343,2019-05-14 15:55:00,66,70.4,46,60.4,112,66.3,2,0
1344,2019-05-14 16:00:00,55,70.3,39,60.2,94,66.1,2,0
1345,2019-05-14 16:05:00,68,70.4,47,60.9,115,66.5,2,0
1346,2019-05-14 16:10:00,72,70.5,49,61.4,121,66.8,2,0
1347,2019-05-14 16:15:00,61,70.4,42,61.0,103,66.6,2,0
1348,2019-05-14 16:20:00,79,70.4,54,60.7,133,66.4,2,0
1349,2019-05-14 16:25:00,72,70.4,49,60.6,121,66.4,2,0
1350,2019-05-14 16:30:00,63,70.3,44,60.0,107,66.1,2,0
1351,2019-05-14 16:35:00,77,70.4,53,60.8,130,66.5,2,0
1352,2019-05-14 16:40:00,82,70.4,56,60.8,138,66.5,2,0
1353,2019-05-14 16:45:00,76,70.4,52,60.9,128,66.5,2,0
1354,2019-05-14 16:50:00,79,70.4,54,60.8,133,66.5,2,0
1355,2019-05-14 16:55:00,79,70.6,54,61.8,133,67.0,2,0
1356,2019-05-14 17:00:00,76,70.5,52,61.3,128,66.7,2,0
1357,2019-05-14 17:05:00,68,70.7,47,62.4,115,67.3,2,0
1358,2019-05-14 17:10:00,76,70.8,52,62.8,128,67.5,2,0
1359,2019-05-14 17:15:00,76,70.6,52,62.1,128,67.2,2,0
1360,2019-05-14 17:20:00,73,70.6,50,61.8,123,67.0,2,0
1361,2019-05-14 17:25:00,66,70.7,46,62.3,112,67.2,2,0
1362,2019-05-14 17:30:00,76,70.7,52,62.6,128,67.4,2,0
1363,2019-05-14 17:35:00,66,70.8,46,63.3,112,67.7,2,0
1364,2019-05-14 17:40:00,81,70.7,55,62.6,136,67.5,2,0
1365,2019-05-14 17:45:00,76,70.7,52,62.5,128,67.4,2,0
1366,2019-05-14 17:50:00,63,70.6,44,62.0,107,67.1,2,0
1367,2019-05-14 17:55:00,63,70.5,44,61.3,107,66.7,2,0
1368,2019-05-14 18:00:00,56,70.7,39,62.8,95,67.5,2,0
1369,2019-05-14 18:05:00,63,70.8,44,62.9,107,67.5,2,0
1370,2019-05-14 18:10:00,65,70.7,45,62.6,110,67.4,2,0
1371,2019-05-14 18:15:00,50,70.6,36,62.0,86,67.0,2,0
1372,2019-05-14 18:20:00,68,70.7,47,62.5,115,67.3,2,0
1373,2019-05-14 18:25:00,53,70.6,37,61.7,90,66.9,2,0
1374,2019-05-14 18:30:00,53,70.8,37,62.8,90,67.5,2,0
1375,2019-05-14 18:35:00,48,70.7,34,62.4,82,67.3,2,0
1376,2019-05-14 18:40:00,48,70.8,34,62.9,82,67.5,2,0
1377,2019-05-14 18:45:00,46,70.5,33,61.3,79,66.6,2,0
1378,2019-05-14 18:50:00,43,70.3,31,60.3,74,66.1,2,0
1379,2019-05-14 18:55:00,57,70.6,40,61.6,97,66.9,2,0
1380,2019-05-14 19:00:00,54,70.8,38,63.1,92,67.6,2,0
1381,2019-05-14 19:05:00,49,70.8,35,63.2,84,67.6,2,0
1382,2019-05-14 19:10:00,58,70.6,41,61.9,99,67.0,2,0
1383,2019-05-14 19:15:00,44,70.6,32,62.0,76,67.0,2,0
1384,2019-05-14 19:20:00,41,70.5,30,61.3,71,66.6,2,0
1385,2019-05-14 19:25:00,43,70.6,31,61.7,74,66.9,2,0
1386,2019-05-14 19:30:00,38,70.7,28,62.6,66,67.3,2,0
1387,2019-05-14 19:35:00,35,70.7,26,62.6,61,67.3,2,0
1388,2019-05-14 19:40:00,30,70.8,23,63.0,53,67.4,2,0
1389,2019-05-14 19:45:00,28,70.6,22,62.0,50,66.8,2,0
1390,2019-05-14 19:50:00,27,70.6,21,62.1,48,66.9,2,0
1391,2019-05-14 19:55:00,27,70.5,21,61.5,48,66.6,2,0
1392,2019-05-14 20:00:00,16,70.6,14,62.0,30,66.6,2,0
1393,2019-05-14 20:05:00,29,70.7,22,62.4,51,67.1,2,0
1394,2019-05-14 20:10:00,28,70.7,22,62.7,50,67.2,2,0
1395,2019-05-14 20:15:00,18,70.7,15,62.6,33,67.1,2,0
1396,2019-05-14 20:20:00,29,70.6,22,62.2,51,67.0,2,0
1397,2019-05-14 20:25:00,21,70.4,17,60.7,38,66.1,2,0
1398,2019-05-14 20:30:00,19,70.5,16,61.2,35,66.3,2,0
1399,2019-05-14 20:35:00,22,70.6,18,61.7,40,66.6,2,0
1400,2019-05-14 20:40:00,23,70.6,19,61.7,42,66.6,2,0
1401,2019-05-14 20:45:00,16,70.6,14,61.7,30,66.5,2,0
1402,2019-05-14 20:50:00,21,70.5,17,61.2,38,66.3,2,0
1403,2019-05-14 20:55:00,18,70.2,15,59.8,33,65.5,2,0
1404,2019-05-14 21:00:00,25,70.4,20,60.7,45,66.1,2,0
1405,2019-05-14 21:05:00,23,70.5,19,61.2,42,66.3,2,0
1406,2019-05-14 21:10:00,26,70.5,20,61.6,46,66.6,2,0
1407,2019-05-14 21:15:00,25,70.7,20,62.3,45,67.0,2,0
1408,2019-05-14 21:20:00,19,70.6,16,61.6,35,66.5,2,0
1409,2019-05-14 21:25:00,25,70.6,20,61.7,45,66.6,2,0
1410,2019-05-14 21:30:00,27,70.6,21,62.1,48,66.9,2,0
1411,2019-05-14 21:35:00,14,70.6,13,61.9,27,66.4,2,0
1412,2019-05-14 21:40:00,18,70.7,15,62.3,33,66.8,2,0
1413,2019-05-14 21:45:00,21,70.7,17,62.2,38,66.9,2,0
1414,2019-05-14 21:50:00,16,70.6,14,61.7,30,66.4,2,0
1415,2019-05-14 21:55:00,16,70.6,14,62.1,30,66.7,2,0
1416,2019-05-14 22:00:00,16,70.7,14,62.3,30,66.8,2,0
1417,2019-05-14 22:05:00,18,70.7,15,62.7,33,67.1,2,0
1418,2019-05-14 22:10:00,16,70.6,14,62.1,30,66.7,2,0
1419,2019-05-14 22:15:00,9,70.5,10,61.2,19,65.6,2,0
1420,2019-05-14 22:20:00,16,70.6,14,61.7,30,66.4,2,0
1421,2019-05-14 22:25:00,14,70.5,13,61.5,27,66.2,2,0
1422,2019-05-14 22:30:00,20,70.6,17,61.7,37,66.5,2,0
1423,2019-05-14 22:35:00,10,70.6,10,62.2,20,66.4,2,0
1424,2019-05-14 22:40:00,18,70.7,15,62.4,33,66.9,2,0
1425,2019-05-14 22:45:00,3,70.7,6,62.4,9,65.2,2,0
1426,2019-05-14 22:50:00,5,70.6,8,62.1,13,65.4,2,0
1427,2019-05-14 22:55:00,13,70.6,13,62.1,26,66.3,2,0
1428,2019-05-14 23:00:00,8,70.6,9,62.0,17,66.1,2,0
1429,2019-05-14 23:05:00,5,70.7,8,62.3,13,65.5,2,0
1430,2019-05-14 23:10:00,10,70.6,10,61.6,20,66.1,2,0
1431,2019-05-14 23:15:00,3,70.6,6,61.9,9,64.8,2,0
1432,2019-05-14 23:20:00,11,70.5,11,61.1,22,65.8,2,0
1433,2019-05-14 23:25:00,2,70.5,5,61.4,7,64.0,2,0
1434,2019-05-14 23:30:00,2,70.6,5,61.8,7,64.3,2,0
1435,2019-05-14 23:35:00,11,70.6,11,61.9,22,66.2,2,0
1436,2019-05-14 23:40:00,3,70.7,6,62.2,9,65.0,2,0
1437,2019-05-14 23:45:00,12,66.3,2,62.3,14,65.8,2,0
1438,2019-05-14 23:50:00,7,70.7,8,62.5,15,66.3,2,0
1439,2019-05-14 23:55:00,14,66.7,4,62.4,18,65.8,2,0
1440,2019-05-15 00:00:00,13,66.2,3,62.2,16,65.5,2,0
1441,2019-05-15 00:05:00,14,66.6,4,62.4,18,65.6,2,0
1442,2019-05-15 00:10:00,1,70.7,5,62.5,6,63.8,2,0
1443,2019-05-15 00:15:00,7,70.7,8,62.3,15,66.2,2,0
1444,2019-05-15 00:20:00,3,70.7,6,62.2,9,65.0,2,0
1445,2019-05-15 00:25:00,13,66.4,3,62.3,16,65.6,2,0
1446,2019-05-15 00:30:00,2,70.6,5,62.1,7,64.6,2,0
1447,2019-05-15 00:35:00,2,70.7,5,62.5,7,64.8,2,0
1448,2019-05-15 00:40:00,12,65.5,2,61.9,14,65.0,2,0
1449,2019-05-15 00:45:00,1,70.7,5,62.2,6,63.6,2,0
1450,2019-05-15 00:50:00,13,66.3,3,62.3,16,65.6,2,0
1451,2019-05-15 00:55:00,14,66.2,4,62.2,18,65.3,2,0
1452,2019-05-15 01:00:00,13,66.0,3,62.1,16,65.3,2,0
1453,2019-05-15 01:05:00,1,70.6,5,61.7,6,63.2,2,0
1454,2019-05-15 01:10:00,1,70.6,5,62.1,6,63.5,2,0
1455,2019-05-15 01:15:00,13,66.2,3,62.2,16,65.5,2,0
1456,2019-05-15 01:20:00,11,66.0,1,62.1,12,65.7,2,0
1457,2019-05-15 01:25:00,4,70.7,7,62.4,11,65.4,2,0
1458,2019-05-15 01:30:00,13,66.4,3,62.3,16,65.6,2,0
1459,2019-05-15 01:35:00,11,66.7,1,62.4,12,66.3,2,0
1460,2019-05-15 01:40:00,1,70.7,5,62.3,6,63.7,2,0
1461,2019-05-15 01:45:00,5,70.6,8,61.7,13,65.1,2,0
1462,2019-05-15 01:50:00,3,70.6,6,62.1,9,65.0,2,0
1463,2019-05-15 01:55:00,11,65.6,1,62.0,12,65.3,2,0
1464,2019-05-15 02:00:00,2,70.6,5,61.8,7,64.3,2,0
1465,2019-05-15 02:05:00,10,65.6,1,62.0,11,65.3,2,0
1466,2019-05-15 02:10:00,10,65.6,1,61.9,11,65.2,2,0
1467,2019-05-15 02:15:00,11,65.2,1,61.8,12,64.9,2,0
1468,2019-05-15 02:20:00,9,66.1,29,62.3,38,63.2,2,0
1469,2019-05-15 02:25:00,2,70.6,5,62.0,7,64.5,2,0
1470,2019-05-15 02:30:00,14,65.5,4,61.9,18,64.7,2,0
1471,2019-05-15 02:35:00,13,66.0,3,62.1,16,65.3,2,0
1472,2019-05-15 02:40:00,13,66.1,3,62.2,16,65.3,2,0
1473,2019-05-15 02:45:00,13,66.3,3,62.3,16,65.6,2,0
1474,2019-05-15 02:50:00,13,66.6,3,62.4,16,65.8,2,0
1475,2019-05-15 02:55:00,13,66.1,3,62.2,16,65.3,2,0
1476,2019-05-15 03:00:00,13,65.8,3,62.0,16,65.1,2,0
1477,2019-05-15 03:05:00,13,66.3,3,62.3,16,65.5,2,0
1478,2019-05-15 03:10:00,14,66.6,4,62.4,18,65.6,2,0
1479,2019-05-15 03:15:00,11,66.7,1,62.4,12,66.3,2,0
1480,2019-05-15 03:20:00,13,65.6,3,62.0,16,64.9,2,0
1481,2019-05-15 03:25:00,14,65.2,4,61.8,18,64.4,2,0
1482,2019-05-15 03:30:00,9,66.1,29,62.3,38,63.2,2,0
1483,2019-05-15 03:35:00,10,65.9,1,62.1,11,65.6,2,0
1484,2019-05-15 03:40:00,1,70.6,5,61.8,6,63.2,2,0
1485,2019-05-15 03:45:00,1,70.6,5,61.7,6,63.2,2,0
1486,2019-05-15 03:50:00,13,65.5,3,61.9,16,64.8,2,0
1487,2019-05-15 03:55:00,1,70.4,5,60.9,6,62.4,2,0
1488,2019-05-15 04:00:00,13,64.4,3,61.4,16,63.9,2,0
1489,2019-05-15 04:05:00,13,65.6,3,62.0,16,64.9,2,0
1490,2019-05-15 04:10:00,3,70.5,6,61.4,9,64.4,2,0
1491,2019-05-15 04:15:00,13,65.0,3,61.7,16,64.4,2,0
1492,2019-05-15 04:20:00,14,65.7,4,62.0,18,64.9,2,0
1493,2019-05-15 04:25:00,1,70.7,5,62.2,6,63.6,2,0
1494,2019-05-15 04:30:00,3,70.7,6,62.3,9,65.1,2,0
1495,2019-05-15 04:35:00,1,70.7,5,62.4,6,63.8,2,0
1496,2019-05-15 04:40:00,4,70.7,7,62.6,11,65.6,2,0
1497,2019-05-15 04:45:00,10,70.7,10,62.4,20,66.6,2,0
1498,2019-05-15 04:50:00,10,70.6,10,62.1,20,66.4,2,0
1499,2019-05-15 04:55:00,7,70.6,8,61.9,15,65.9,2,0
1500,2019-05-15 05:00:00,9,70.6,10,62.0,19,66.1,2,0
1501,2019-05-15 05:05:00,7,70.6,8,61.8,15,65.9,2,0
1502,2019-05-15 05:10:00,16,70.6,14,61.8,30,66.5,2,0
1503,2019-05-15 05:15:00,16,70.6,14,61.7,30,66.4,2,0
1504,2019-05-15 05:20:00,11,70.6,11,61.9,22,66.2,2,0
1505,2019-05-15 05:25:00,25,70.6,20,62.0,45,66.8,2,0
1506,2019-05-15 05:30:00,14,70.6,13,61.9,27,66.4,2,0
1507,2019-05-15 05:35:00,19,70.6,16,62.0,35,66.7,2,0
1508,2019-05-15 05:40:00,23,70.5,19,61.4,42,66.4,2,0
1509,2019-05-15 05:45:00,27,70.5,21,61.4,48,66.5,2,0
1510,2019-05-15 05:50:00,26,70.7,20,62.5,46,67.2,2,0
1511,2019-05-15 05:55:00,34,70.6,25,62.1,59,67.0,2,0
1512,2019-05-15 06:00:00,27,70.5,21,61.3,48,66.5,2,0
1513,2019-05-15 06:05:00,19,70.5,16,61.4,35,66.3,2,0
1514,2019-05-15 06:10:00,38,70.8,28,63.0,66,67.5,2,0
1515,2019-05-15 06:15:00,32,70.5,25,61.2,57,66.4,2,0
1516,2019-05-15 06:20:00,43,70.7,31,62.7,74,67.4,2,0
1517,2019-05-15 06:25:00,41,70.6,30,61.7,71,66.8,2,0
1518,2019-05-15 06:30:00,43,70.8,31,63.2,74,67.7,2,0
1519,2019-05-15 06:35:00,41,70.8,30,63.1,71,67.6,2,0
1520,2019-05-15 06:40:00,57,70.8,40,63.0,97,67.6,2,0
1521,2019-05-15 06:45:00,43,70.5,31,61.2,74,66.6,2,0
1522,2019-05-15 06:50:00,50,70.3,36,59.9,86,65.9,2,0
1523,2019-05-15 06:55:00,55,70.6,39,61.8,94,66.9,2,0
1524,2019-05-15 07:00:00,59,70.4,42,60.8,101,66.4,2,0
1525,2019-05-15 07:05:00,55,70.1,39,59.2,94,65.6,2,0
1526,2019-05-15 07:10:00,53,70.0,37,58.3,90,65.2,2,0
1527,2019-05-15 07:15:00,67,70.0,46,58.5,113,65.3,2,0
1528,2019-05-15 07:20:00,70,70.0,48,58.1,118,65.1,2,0
1529,2019-05-15 07:25:00,71,70.0,49,58.6,120,65.4,2,0
1530,2019-05-15 07:30:00,72,70.1,49,59.0,121,65.6,2,0
1531,2019-05-15 07:35:00,67,70.0,46,58.5,113,65.3,2,0
1532,2019-05-15 07:40:00,54,69.9,38,57.8,92,64.9,2,0
1533,2019-05-15 07:45:00,38,70.3,28,60.3,66,66.1,2,0
1534,2019-05-15 07:50:00,28,70.0,22,58.4,50,64.9,2,0
1535,2019-05-15 07:55:00,47,70.3,34,60.2,81,66.1,2,0
1536,2019-05-15 08:00:00,47,70.4,34,60.8,81,66.4,2,0
1537,2019-05-15 08:05:00,86,70.2,59,59.8,145,66.0,2,0
1538,2019-05-15 08:10:00,88,70.1,59,58.9,147,65.6,2,0
1539,2019-05-15 08:15:00,84,70.1,57,58.6,141,65.4,2,0
1540,2019-05-15 08:20:00,84,70.1,57,59.1,141,65.7,2,0
1541,2019-05-15 08:25:00,90,70.1,61,59.2,151,65.7,2,0
1542,2019-05-15 08:30:00,58,70.4,41,60.6,99,66.3,2,0
1543,2019-05-15 08:35:00,61,70.3,42,60.2,103,66.2,2,0
1544,2019-05-15 08:40:00,52,70.1,37,58.8,89,65.4,2,0
1545,2019-05-15 08:45:00,74,70.3,51,60.1,125,66.2,2,0
1546,2019-05-15 08:50:00,48,70.2,34,59.2,82,65.6,2,0
1547,2019-05-15 08:55:00,61,70.1,42,58.6,103,65.4,2,0
1548,2019-05-15 09:00:00,37,70.1,27,59.0,64,65.4,2,0
1549,2019-05-15 09:05:00,54,70.0,38,58.4,92,65.2,2,0
1550,2019-05-15 09:10:00,40,69.7,30,56.8,70,64.2,2,0
1551,2019-05-15 09:15:00,55,69.7,39,56.6,94,64.3,2,0
1552,2019-05-15 09:20:00,47,70.0,34,58.5,81,65.2,2,0
1553,2019-05-15 09:25:00,43,69.9,31,57.9,74,64.9,2,0
1554,2019-05-15 09:30:00,62,70.1,43,58.7,105,65.4,2,0
1555,2019-05-15 09:35:00,41,70.0,30,58.1,71,64.9,2,0
1556,2019-05-15 09:40:00,38,69.9,28,57.9,66,64.8,2,0
1557,2019-05-15 09:45:00,55,70.1,39,58.9,94,65.5,2,0
1558,2019-05-15 09:50:00,49,70.2,35,59.5,84,65.8,2,0
1559,2019-05-15 09:55:00,41,70.1,30,59.2,71,65.5,2,0
1560,2019-05-15 10:00:00,35,70.5,26,61.3,61,66.6,2,0
1561,2019-05-15 10:05:00,40,70.7,30,62.4,70,67.1,2,0
1562,2019-05-15 10:10:00,40,70.6,30,61.6,70,66.7,2,0
1563,2019-05-15 10:15:00,39,70.6,29,61.7,68,66.8,2,0
1564,2019-05-15 10:20:00,36,70.7,27,62.4,63,67.2,2,0
1565,2019-05-15 10:25:00,46,70.5,33,61.5,79,66.7,2,0
1566,2019-05-15 10:30:00,47,70.8,34,63.0,81,67.5,2,0
1567,2019-05-15 10:35:00,44,70.8,32,63.2,76,67.6,2,0
1568,2019-05-15 10:40:00,45,70.7,32,62.6,77,67.3,2,0
1569,2019-05-15 10:45:00,45,70.7,32,62.7,77,67.4,2,0
1570,2019-05-15 10:50:00,54,70.7,38,62.5,92,67.3,2,0
1571,2019-05-15 10:55:00,44,70.7,32,62.5,76,67.3,2,0
1572,2019-05-15 11:00:00,52,70.7,37,62.8,89,67.4,2,0
1573,2019-05-15 11:05:00,39,70.9,29,63.4,68,67.7,2,0
1574,2019-05-15 11:10:00,39,70.9,29,63.7,68,67.8,2,0
1575,2019-05-15 11:15:00,41,70.8,30,62.9,71,67.4,2,0
1576,2019-05-15 11:20:00,45,71.0,32,64.1,77,68.1,2,0
1577,2019-05-15 11:25:00,44,70.7,32,62.4,76,67.2,2,0
1578,2019-05-15 11:30:00,48,70.7,34,62.6,82,67.4,2,0
1579,2019-05-15 11:35:00,48,70.6,34,61.9,82,67.0,2,0
1580,2019-05-15 11:40:00,48,70.3,34,59.9,82,66.0,2,0
1581,2019-05-15 11:45:00,41,70.4,30,61.0,71,66.4,2,0
1582,2019-05-15 11:50:00,49,70.9,35,63.5,84,67.8,2,0
1583,2019-05-15 11:55:00,54,70.8,38,62.9,92,67.5,2,0
1584,2019-05-15 12:00:00,43,70.6,31,61.6,74,66.8,2,0
1585,2019-05-15 12:05:00,44,70.4,32,60.5,76,66.2,2,0
1586,2019-05-15 12:10:00,45,70.2,32,59.5,77,65.8,2,0
1587,2019-05-15 12:15:00,49,70.2,35,59.5,84,65.7,2,0
1588,2019-05-15 12:20:00,58,70.5,41,61.3,99,66.7,2,0
1589,2019-05-15 12:25:00,53,70.7,37,62.5,90,67.3,2,0
1590,2019-05-15 12:30:00,45,70.6,32,61.8,77,66.9,2,0
1591,2019-05-15 12:35:00,49,71.1,35,64.6,84,68.3,2,0
1592,2019-05-15 12:40:00,35,70.8,26,62.8,61,67.4,2,0
1593,2019-05-15 12:45:00,49,70.8,35,63.0,84,67.6,2,0
1594,2019-05-15 12:50:00,49,70.7,35,62.4,84,67.3,2,0
1595,2019-05-15 12:55:00,45,70.5,32,61.3,77,66.7,2,0
1596,2019-05-15 13:00:00,32,70.2,25,59.4,57,65.5,2,0
1597,2019-05-15 13:05:00,52,70.0,37,58.4,89,65.2,2,0
1598,2019-05-15 13:10:00,53,70.0,37,58.4,90,65.2,2,0
1599,2019-05-15 13:15:00,55,70.1,39,59.1,94,65.6,2,0
1600,2019-05-15 13:20:00,58,70.3,41,60.3,99,66.2,2,0
1601,2019-05-15 13:25:00,49,70.0,35,58.3,84,65.1,2,0
1602,2019-05-15 13:30:00,63,70.0,44,58.4,107,65.3,2,0
1603,2019-05-15 13:35:00,48,70.1,34,58.9,82,65.5,2,0
1604,2019-05-15 13:40:00,56,70.3,39,60.3,95,66.2,2,0
1605,2019-05-15 13:45:00,56,70.2,39,59.4,95,65.8,2,0
1606,2019-05-15 13:50:00,68,70.1,47,58.8,115,65.5,2,0
1607,2019-05-15 13:55:00,70,70.2,48,59.4,118,65.8,2,0
1608,2019-05-15 14:00:00,63,70.0,44,58.1,107,65.1,2,0
1609,2019-05-15 14:05:00,61,69.9,42,57.6,103,64.9,2,0
1610,2019-05-15 14:10:00,64,69.9,44,57.8,108,65.0,2,0
1611,2019-05-15 14:15:00,71,70.1,49,59.1,120,65.6,2,0
1612,2019-05-15 14:20:00,47,69.8,34,57.0,81,64.4,2,0
1613,2019-05-15 14:25:00,61,69.8,42,57.2,103,64.7,2,0
1614,2019-05-15 14:30:00,65,69.9,45,57.5,110,64.8,2,0
1615,2019-05-15 14:35:00,77,70.0,53,58.4,130,65.3,2,0
1616,2019-05-15 14:40:00,75,70.1,51,59.2,126,65.7,2,0
1617,2019-05-15 14:45:00,79,70.3,54,60.0,133,66.1,2,0
1618,2019-05-15 14:50:00,57,70.3,40,60.3,97,66.2,2,0
1619,2019-05-15 14:55:00,70,70.4,48,60.8,118,66.5,2,0
1620,2019-05-15 15:00:00,44,70.4,32,60.9,76,66.4,2,0
1621,2019-05-15 15:05:00,65,70.2,45,59.6,110,65.9,2,0
1622,2019-05-15 15:10:00,63,70.3,44,60.2,107,66.2,2,0
1623,2019-05-15 15:15:00,75,70.2,51,59.6,126,65.9,2,0
1624,2019-05-15 15:20:00,75,70.4,51,60.8,126,66.5,2,0
1625,2019-05-15 15:25:00,61,70.3,42,60.3,103,66.2,2,0
1626,2019-05-15 15:30:00,61,70.2,42,59.7,103,66.0,2,0
1627,2019-05-15 15:35:00,67,70.4,46,60.8,113,66.5,2,0
1628,2019-05-15 15:40:00,62,70.4,43,60.8,105,66.5,2,0
1629,2019-05-15 15:45:00,80,70.4,54,60.6,134,66.5,2,0
1630,2019-05-15 15:50:00,83,70.4,56,60.8,139,66.6,2,0
1631,2019-05-15 15:55:00,82,70.6,56,62.1,138,67.2,2,0
1632,2019-05-15 16:00:00,61,70.7,42,62.7,103,67.5,2,0
1633,2019-05-15 16:05:00,68,70.6,47,62.2,115,67.2,2,0
1634,2019-05-15 16:10:00,55,70.5,39,61.2,94,66.7,2,0
1635,2019-05-15 16:15:00,61,70.3,42,60.4,103,66.3,2,0
1636,2019-05-15 16:20:00,66,70.4,46,60.7,112,66.4,2,0
1637,2019-05-15 16:25:00,74,70.2,51,59.6,125,65.9,2,0
1638,2019-05-15 16:30:00,66,70.4,46,60.9,112,66.5,2,0
1639,2019-05-15 16:35:00,80,70.6,54,61.7,134,67.0,2,0
1640,2019-05-15 16:40:00,70,70.5,48,61.2,118,66.7,2,0
1641,2019-05-15 16:45:00,76,70.6,52,61.6,128,66.9,2,0
1642,2019-05-15 16:50:00,54,70.5,38,61.5,92,66.8,2,0
1643,2019-05-15 16:55:00,70,70.4,48,60.5,118,66.4,2,0
1644,2019-05-15 17:00:00,62,70.5,43,61.1,105,66.7,2,0
1645,2019-05-15 17:05:00,72,70.5,49,61.3,121,66.8,2,0
1646,2019-05-15 17:10:00,72,70.6,49,61.8,121,67.0,2,0
1647,2019-05-15 17:15:00,64,70.7,44,62.5,108,67.4,2,0
1648,2019-05-15 17:20:00,56,70.4,39,60.8,95,66.5,2,0
1649,2019-05-15 17:25:00,76,70.5,52,61.2,128,66.7,2,0
1650,2019-05-15 17:30:00,67,70.4,46,60.9,113,66.5,2,0
1651,2019-05-15 17:35:00,66,70.5,46,61.2,112,66.7,2,0
1652,2019-05-15 17:40:00,67,70.5,46,61.3,113,66.8,2,0
1653,2019-05-15 17:45:00,70,70.3,48,60.0,118,66.1,2,0
1654,2019-05-15 17:50:00,68,70.4,47,60.5,115,66.3,2,0
1655,2019-05-15 17:55:00,54,70.3,38,60.1,92,66.1,2,0
1656,2019-05-15 18:00:00,57,70.1,40,59.2,97,65.6,2,0
1657,2019-05-15 18:05:00,57,70.4,40,60.7,97,66.4,2,0
1658,2019-05-15 18:10:00,49,70.3,35,60.3,84,66.1,2,0
1659,2019-05-15 18:15:00,59,70.4,42,60.8,101,66.4,2,0
1660,2019-05-15 18:20:00,50,70.6,36,61.9,86,66.9,2,0
1661,2019-05-15 18:25:00,46,70.4,33,61.0,79,66.5,2,0
1662,2019-05-15 18:30:00,68,70.5,47,61.6,115,66.9,2,0
1663,2019-05-15 18:35:00,44,70.2,32,59.7,76,65.8,2,0
1664,2019-05-15 18:40:00,56,70.2,39,59.4,95,65.8,2,0
1665,2019-05-15 18:45:00,31,70.4,24,60.9,55,66.2,2,0
1666,2019-05-15 18:50:00,54,70.6,38,61.6,92,66.8,2,0
1667,2019-05-15 18:55:00,45,70.5,32,61.1,77,66.6,2,0
1668,2019-05-15 19:00:00,54,70.5,38,61.0,92,66.6,2,0
1669,2019-05-15 19:05:00,50,70.5,36,61.5,86,66.7,2,0
1670,2019-05-15 19:10:00,47,70.6,34,62.1,81,67.0,2,0
1671,2019-05-15 19:15:00,44,70.6,32,61.7,76,66.9,2,0
1672,2019-05-15 19:20:00,48,70.6,34,61.7,82,66.9,2,0
1673,2019-05-15 19:25:00,50,70.6,36,61.8,86,66.9,2,0
1674,2019-05-15 19:30:00,45,70.6,32,61.8,77,66.9,2,0
1675,2019-05-15 19:35:00,25,70.3,20,60.1,45,65.8,2,0
1676,2019-05-15 19:40:00,38,70.6,28,61.6,66,66.8,2,0
1677,2019-05-15 19:45:00,36,70.5,27,61.5,63,66.7,2,0
1678,2019-05-15 19:50:00,17,70.6,15,61.7,32,66.4,2,0
1679,2019-05-15 19:55:00,25,70.3,20,60.2,45,65.8,2,0
1680,2019-05-15 20:00:00,28,70.5,22,61.1,50,66.3,2,0
1681,2019-05-15 20:05:00,26,70.3,20,60.1,46,65.9,2,0
1682,2019-05-15 20:10:00,26,70.4,20,60.9,46,66.3,2,0
1683,2019-05-15 20:15:00,27,70.5,21,61.4,48,66.5,2,0
1684,2019-05-15 20:20:00,25,70.4,20,60.8,45,66.2,2,0
1685,2019-05-15 20:25:00,31,70.4,24,61.0,55,66.3,2,0
1686,2019-05-15 20:30:00,22,70.4,18,60.7,40,66.0,2,0
1687,2019-05-15 20:35:00,20,70.4,17,60.9,37,66.1,2,0
1688,2019-05-15 20:40:00,30,70.5,23,61.2,53,66.4,2,0
1689,2019-05-15 20:45:00,17,70.4,15,60.9,32,66.0,2,0
1690,2019-05-15 20:50:00,14,70.5,13,61.1,27,66.0,2,0
1691,2019-05-15 20:55:00,23,70.3,19,60.1,42,65.7,2,0
1692,2019-05-15 21:00:00,20,70.4,17,60.9,37,66.1,2,0
1693,2019-05-15 21:05:00,19,70.5,16,61.5,35,66.4,2,0
1694,2019-05-15 21:10:00,23,70.5,19,61.3,42,66.3,2,0
1695,2019-05-15 21:15:00,23,70.4,19,60.6,42,66.0,2,0
1696,2019-05-15 21:20:00,18,70.5,15,61.1,33,66.2,2,0
1697,2019-05-15 21:25:00,16,70.4,14,60.7,30,65.9,2,0
1698,2019-05-15 21:30:00,19,70.5,16,61.4,35,66.3,2,0
1699,2019-05-15 21:35:00,25,70.3,20,60.3,45,65.9,2,0
1700,2019-05-15 21:40:00,30,70.3,23,60.2,53,65.9,2,0
1701,2019-05-15 21:45:00,18,70.1,15,58.8,33,64.9,2,0
1702,2019-05-15 21:50:00,20,70.4,17,60.7,37,65.9,2,0
1703,2019-05-15 21:55:00,11,70.6,11,61.6,22,66.1,2,0
1704,2019-05-15 22:00:00,11,70.6,11,61.7,22,66.1,2,0
1705,2019-05-15 22:05:00,8,70.3,9,60.3,17,65.0,2,0
1706,2019-05-15 22:10:00,14,70.4,13,60.5,27,65.6,2,0
1707,2019-05-15 22:15:00,9,70.5,10,61.2,19,65.6,2,0
1708,2019-05-15 22:20:00,11,70.6,11,61.8,22,66.2,2,0
1709,2019-05-15 22:25:00,5,70.6,8,61.8,13,65.2,2,0
1710,2019-05-15 22:30:00,18,70.6,15,62.2,33,66.8,2,0
1711,2019-05-15 22:35:00,18,70.6,15,61.6,33,66.5,2,0
1712,2019-05-15 22:40:00,10,70.6,10,61.7,20,66.1,2,0
1713,2019-05-15 22:45:00,4,70.6,7,61.9,11,65.1,2,0
1714,2019-05-15 22:50:00,13,70.6,13,61.7,26,66.1,2,0
1715,2019-05-15 22:55:00,12,70.6,12,61.9,24,66.2,2,0
1716,2019-05-15 23:00:00,7,70.6,8,61.7,15,65.9,2,0
1717,2019-05-15 23:05:00,5,70.6,8,61.8,13,65.2,2,0
1718,2019-05-15 23:10:00,1,70.6,5,62.0,6,63.5,2,0
1719,2019-05-15 23:15:00,3,70.6,6,62.1,9,65.0,2,0
1720,2019-05-15 23:20:00,4,70.6,7,62.2,11,65.2,2,0
1721,2019-05-15 23:25:00,1,70.7,5,62.3,6,63.7,2,0
1722,2019-05-15 23:30:00,1,70.7,5,62.2,6,63.6,2,0
1723,2019-05-15 23:35:00,3,70.6,6,62.2,9,65.0,2,0
1724,2019-05-15 23:40:00,14,65.8,4,62.0,18,64.9,2,0
1725,2019-05-15 23:45:00,8,70.6,9,61.6,17,65.8,2,0
1726,2019-05-15 23:50:00,13,65.1,3,61.7,16,64.5,2,0
1727,2019-05-15 23:55:00,7,70.6,8,62.1,15,66.1,2,0
1728,2019-05-16 00:00:00,1,70.7,5,62.2,6,63.6,2,0
1729,2019-05-16 00:05:00,4,70.7,7,62.4,11,65.4,2,0
1730,2019-05-16 00:10:00,1,70.7,5,62.4,6,63.8,2,0
1731,2019-05-16 00:15:00,13,66.6,3,62.4,16,65.8,2,0
1732,2019-05-16 00:20:00,7,70.7,8,62.4,15,66.3,2,0
1733,2019-05-16 00:25:00,8,70.7,9,62.5,17,66.4,2,0
1734,2019-05-16 00:30:00,1,70.7,5,62.5,6,63.9,2,0
1735,2019-05-16 00:35:00,13,66.1,3,62.2,16,65.4,2,0
1736,2019-05-16 00:40:00,13,66.3,3,62.3,16,65.5,2,0
1737,2019-05-16 00:45:00,4,70.6,7,62.0,11,65.2,2,0
1738,2019-05-16 00:50:00,14,65.9,4,62.1,18,65.1,2,0
1739,2019-05-16 00:55:00,13,65.5,3,61.9,16,64.8,2,0
1740,2019-05-16 01:00:00,14,65.6,4,62.0,18,64.8,2,0
1741,2019-05-16 01:05:00,14,66.1,4,62.2,18,65.3,2,0
1742,2019-05-16 01:10:00,13,66.2,3,62.2,16,65.5,2,0
1743,2019-05-16 01:15:00,2,70.4,5,60.8,7,63.5,2,0
1744,2019-05-16 01:20:00,5,70.5,8,61.4,13,64.9,2,0
1745,2019-05-16 01:25:00,13,65.6,3,62.0,16,64.9,2,0
1746,2019-05-16 01:30:00,5,70.7,8,62.3,13,65.5,2,0
1747,2019-05-16 01:35:00,14,66.3,4,62.3,18,65.4,2,0
1748,2019-05-16 01:40:00,2,70.6,5,61.9,7,64.4,2,0
1749,2019-05-16 01:45:00,4,70.6,7,61.9,11,65.1,2,0
1750,2019-05-16 01:50:00,14,65.8,4,62.1,18,65.0,2,0
1751,2019-05-16 01:55:00,12,66.2,2,62.2,14,65.6,2,0
1752,2019-05-16 02:00:00,13,66.1,3,62.2,16,65.4,2,0
1753,2019-05-16 02:05:00,9,66.1,29,62.3,38,63.2,2,0
1754,2019-05-16 02:10:00,12,66.1,2,62.2,14,65.5,2,0
1755,2019-05-16 02:15:00,13,66.8,3,62.5,16,66.0,2,0
1756,2019-05-16 02:20:00,10,66.3,1,62.3,11,66.0,2,0
1757,2019-05-16 02:25:00,13,65.7,3,62.0,16,65.0,2,0
1758,2019-05-16 02:30:00,14,65.6,4,61.9,18,64.8,2,0
1759,2019-05-16 02:35:00,14,66.3,4,62.3,18,65.4,2,0
1760,2019-05-16 02:40:00,13,66.9,3,62.5,16,66.1,2,0
1761,2019-05-16 02:45:00,13,66.6,3,62.4,16,65.8,2,0
1762,2019-05-16 02:50:00,14,67.0,4,62.6,18,66.0,2,0
1763,2019-05-16 02:55:00,11,66.3,1,62.3,12,65.9,2,0
1764,2019-05-16 03:00:00,12,66.7,2,62.4,14,66.1,2,0
1765,2019-05-16 03:05:00,13,66.2,3,62.2,16,65.5,2,0
1766,2019-05-16 03:10:00,4,70.6,7,62.1,11,65.2,2,0
1767,2019-05-16 03:15:00,10,65.8,1,62.0,11,65.4,2,0
1768,2019-05-16 03:20:00,2,70.6,5,62.1,7,64.6,2,0
1769,2019-05-16 03:25:00,1,70.7,5,62.4,6,63.8,2,0
1770,2019-05-16 03:30:00,13,66.8,3,62.5,16,66.0,2,0
1771,2019-05-16 03:35:00,12,66.3,2,62.3,14,65.7,2,0
1772,2019-05-16 03:40:00,12,66.2,2,62.2,14,65.6,2,0
1773,2019-05-16 03:45:00,13,66.7,3,62.4,16,65.9,2,0
1774,2019-05-16 03:50:00,12,66.3,2,62.3,14,65.8,2,0
1775,2019-05-16 03:55:00,2,70.6,5,62.1,7,64.5,2,0
1776,2019-05-16 04:00:00,13,65.4,3,61.9,16,64.8,2,0
1777,2019-05-16 04:05:00,11,65.1,1,61.7,12,64.9,2,0
1778,2019-05-16 04:10:00,13,65.1,3,61.7,16,64.4,2,0
1779,2019-05-16 04:15:00,4,70.5,7,61.3,11,64.7,2,0
1780,2019-05-16 04:20:00,13,65.6,3,61.9,16,64.9,2,0
1781,2019-05-16 04:25:00,2,70.6,5,62.1,7,64.6,2,0
1782,2019-05-16 04:30:00,8,70.7,9,62.3,17,66.2,2,0
1783,2019-05-16 04:35:00,4,70.7,7,62.4,11,65.4,2,0
1784,2019-05-16 04:40:00,9,70.7,10,62.4,19,66.3,2,0
1785,2019-05-16 04:45:00,2,70.7,5,62.4,7,64.8,2,0
1786,2019-05-16 04:50:00,11,70.6,11,61.6,22,66.1,2,0
1787,2019-05-16 04:55:00,7,70.6,8,61.9,15,66.0,2,0
1788,2019-05-16 05:00:00,4,70.6,7,62.1,11,65.2,2,0
1789,2019-05-16 05:05:00,14,70.6,13,61.6,27,66.3,2,0
1790,2019-05-16 05:10:00,17,70.6,15,61.6,32,66.4,2,0
1791,2019-05-16 05:15:00,17,70.5,15,61.2,32,66.1,2,0
1792,2019-05-16 05:20:00,13,70.6,13,61.6,26,66.1,2,0
1793,2019-05-16 05:25:00,25,70.5,20,61.2,45,66.4,2,0
1794,2019-05-16 05:30:00,26,70.7,20,62.4,46,67.1,2,0
1795,2019-05-16 05:35:00,26,70.7,20,62.7,46,67.2,2,0
1796,2019-05-16 05:40:00,23,70.8,19,63.0,42,67.3,2,0
1797,2019-05-16 05:45:00,28,70.8,22,63.1,50,67.4,2,0
1798,2019-05-16 05:50:00,27,70.8,21,63.3,48,67.6,2,0
1799,2019-05-16 05:55:00,27,70.7,21,62.4,48,67.1,2,0
1800,2019-05-16 06:00:00,25,70.4,20,60.9,45,66.2,2,0
1801,2019-05-16 06:05:00,35,70.4,26,60.9,61,66.4,2,0
1802,2019-05-16 06:10:00,37,70.4,27,60.9,64,66.4,2,0
1803,2019-05-16 06:15:00,36,70.6,27,61.7,63,66.8,2,0
1804,2019-05-16 06:20:00,38,70.6,28,62.1,66,67.0,2,0
1805,2019-05-16 06:25:00,53,70.7,37,62.3,90,67.2,2,0
1806,2019-05-16 06:30:00,48,70.7,34,62.4,82,67.2,2,0
1807,2019-05-16 06:35:00,31,70.6,24,61.6,55,66.7,2,0
1808,2019-05-16 06:40:00,49,70.5,35,61.3,84,66.7,2,0
1809,2019-05-16 06:45:00,62,70.6,43,62.0,105,67.1,2,0
1810,2019-05-16 06:50:00,56,70.5,39,61.1,95,66.6,2,0
1811,2019-05-16 06:55:00,55,70.4,39,60.8,94,66.4,2,0
1812,2019-05-16 07:00:00,50,70.1,36,59.1,86,65.5,2,0
1813,2019-05-16 07:05:00,47,70.1,34,58.7,81,65.3,2,0
1814,2019-05-16 07:10:00,59,69.9,42,57.4,101,64.7,2,0
1815,2019-05-16 07:15:00,62,70.2,43,59.5,105,65.8,2,0
1816,2019-05-16 07:20:00,68,70.2,47,59.8,115,66.0,2,0
1817,2019-05-16 07:25:00,61,70.2,42,59.7,103,66.0,2,0
1818,2019-05-16 07:30:00,82,70.3,56,60.3,138,66.3,2,0
1819,2019-05-16 07:35:00,77,70.6,53,61.9,130,67.0,2,0
1820,2019-05-16 07:40:00,79,70.5,54,61.0,133,66.6,2,0
1821,2019-05-16 07:45:00,80,70.4,54,60.5,134,66.4,2,0
1822,2019-05-16 07:50:00,79,70.3,54,60.1,133,66.2,2,0
1823,2019-05-16 07:55:00,74,70.4,51,60.7,125,66.5,2,0
1824,2019-05-16 08:00:00,74,70.5,51,61.0,125,66.6,2,0
1825,2019-05-16 08:05:00,61,70.4,42,60.9,103,66.6,2,0
1826,2019-05-16 08:10:00,70,70.2,48,59.7,118,66.0,2,0
1827,2019-05-16 08:15:00,63,70.2,44,59.5,107,65.8,2,0
1828,2019-05-16 08:20:00,46,70.2,33,59.8,79,65.9,2,0
1829,2019-05-16 08:25:00,77,70.1,53,59.0,130,65.6,2,0
1830,2019-05-16 08:30:00,74,70.3,51,60.3,125,66.2,2,0
1831,2019-05-16 08:35:00,52,70.2,37,59.2,89,65.6,2,0
1832,2019-05-16 08:40:00,73,70.3,50,60.3,123,66.2,2,0
1833,2019-05-16 08:45:00,73,70.5,50,61.1,123,66.6,2,0
1834,2019-05-16 08:50:00,67,70.5,46,61.3,113,66.7,2,0
1835,2019-05-16 08:55:00,54,70.3,38,60.0,92,66.0,2,0
1836,2019-05-16 09:00:00,54,70.2,38,59.8,92,65.9,2,0
1837,2019-05-16 09:05:00,44,70.0,32,58.1,76,65.0,2,0
1838,2019-05-16 09:10:00,57,70.0,40,58.3,97,65.2,2,0
1839,2019-05-16 09:15:00,45,70.1,32,59.1,77,65.5,2,0
1840,2019-05-16 09:20:00,46,70.2,33,59.6,79,65.8,2,0
1841,2019-05-16 09:25:00,63,70.3,44,59.9,107,66.0,2,0
1842,2019-05-16 09:30:00,44,70.2,32,59.3,76,65.6,2,0
1843,2019-05-16 09:35:00,40,70.0,30,58.0,70,64.8,2,0
1844,2019-05-16 09:40:00,46,70.0,33,58.5,79,65.2,2,0
1845,2019-05-16 09:45:00,34,70.2,25,59.6,59,65.7,2,0
1846,2019-05-16 09:50:00,56,70.2,39,59.4,95,65.7,2,0
1847,2019-05-16 09:55:00,41,70.0,30,58.3,71,65.0,2,0
1848,2019-05-16 10:00:00,53,70.4,37,60.6,90,66.4,2,0
1849,2019-05-16 10:05:00,48,70.8,34,63.0,82,67.5,2,0
1850,2019-05-16 10:10:00,39,70.8,29,63.1,68,67.5,2,0
1851,2019-05-16 10:15:00,37,70.7,27,62.2,64,67.1,2,0
1852,2019-05-16 10:20:00,39,70.5,29,61.2,68,66.5,2,0
1853,2019-05-16 10:25:00,46,70.7,33,62.3,79,67.2,2,0
1854,2019-05-16 10:30:00,44,70.8,32,62.9,76,67.4,2,0
1855,2019-05-16 10:35:00,50,70.7,36,62.2,86,67.1,2,0
1856,2019-05-16 10:40:00,41,70.6,30,61.8,71,66.9,2,0
1857,2019-05-16 10:45:00,53,70.7,37,62.3,90,67.2,2,0
1858,2019-05-16 10:50:00,58,70.9,41,63.5,99,67.8,2,0
1859,2019-05-16 10:55:00,39,70.8,29,63.1,68,67.5,2,0
1860,2019-05-16 11:00:00,59,70.7,42,62.5,101,67.3,2,0
1861,2019-05-16 11:05:00,43,70.4,31,60.5,74,66.3,2,0
1862,2019-05-16 11:10:00,41,69.9,30,57.5,71,64.7,2,0
1863,2019-05-16 11:15:00,36,70.0,27,58.2,63,64.9,2,0
1864,2019-05-16 11:20:00,54,70.0,38,58.2,92,65.1,2,0
1865,2019-05-16 11:25:00,41,70.0,30,58.2,71,65.0,2,0
1866,2019-05-16 11:30:00,38,70.1,28,58.8,66,65.3,2,0
1867,2019-05-16 11:35:00,48,69.9,34,58.0,82,65.0,2,0
1868,2019-05-16 11:40:00,47,69.9,34,58.0,81,64.9,2,0
1869,2019-05-16 11:45:00,13,60.9,3,59.9,16,60.7,2,0
1870,2019-05-16 11:50:00,8,60.9,28,57.3,36,58.1,2,0
1871,2019-05-16 11:55:00,3,70.4,6,60.5,9,63.8,2,0
1872,2019-05-16 12:00:00,8,62.4,28,58.8,36,59.6,2,0
1873,2019-05-16 12:05:00,8,62.4,28,58.8,36,59.6,2,0
1874,2019-05-16 12:10:00,8,62.4,28,58.8,36,59.6,2,0
1875,2019-05-16 12:15:00,8,62.4,28,58.8,36,59.6,2,0
1876,2019-05-16 12:20:00,8,62.4,28,58.8,36,59.6,2,0
1877,2019-05-16 12:25:00,8,62.4,28,58.8,36,59.6,2,0
1878,2019-05-16 12:30:00,43,70.1,31,59.0,74,65.5,2,0
1879,2019-05-16 12:35:00,48,69.4,34,54.6,82,63.3,2,0
1880,2019-05-16 12:40:00,125,66.6,113,60.8,238,63.8,2,0
1881,2019-05-16 12:45:00,65,71.2,45,65.4,110,68.8,2,0
1882,2019-05-16 12:50:00,50,70.8,36,63.0,86,67.5,2,0
1883,2019-05-16 12:55:00,52,70.6,37,61.7,89,66.9,2,0
1884,2019-05-16 13:00:00,54,70.5,38,61.3,92,66.7,2,0
1885,2019-05-16 13:05:00,46,70.4,33,60.9,79,66.4,2,0
1886,2019-05-16 13:10:00,58,70.5,41,61.3,99,66.7,2,0
1887,2019-05-16 13:15:00,56,70.5,39,61.6,95,66.9,2,0
1888,2019-05-16 13:20:00,67,70.6,46,61.7,113,67.0,2,0
1889,2019-05-16 13:25:00,53,70.7,37,62.5,90,67.3,2,0
1890,2019-05-16 13:30:00,58,70.8,41,63.3,99,67.7,2,0
1891,2019-05-16 13:35:00,49,70.6,35,61.9,84,67.0,2,0
1892,2019-05-16 13:40:00,71,70.6,49,62.1,120,67.1,2,0
1893,2019-05-16 13:45:00,55,70.8,39,63.0,94,67.5,2,0
1894,2019-05-16 13:50:00,65,70.7,45,62.4,110,67.3,2,0
1895,2019-05-16 13:55:00,61,70.8,42,62.9,103,67.6,2,0
1896,2019-05-16 14:00:00,63,70.9,44,63.9,107,68.1,2,0
1897,2019-05-16 14:05:00,57,70.8,40,63.1,97,67.6,2,0
1898,2019-05-16 14:10:00,50,70.6,36,62.2,86,67.1,2,0
1899,2019-05-16 14:15:00,63,70.5,44,61.5,107,66.8,2,0
1900,2019-05-16 14:20:00,77,70.7,53,62.3,130,67.2,2,0
1901,2019-05-16 14:25:00,61,70.7,42,62.6,103,67.4,2,0
1902,2019-05-16 14:30:00,48,71.0,34,64.5,82,68.3,2,0
1903,2019-05-16 14:35:00,59,70.9,42,63.9,101,68.0,2,0
1904,2019-05-16 14:40:00,65,71.1,45,64.6,110,68.4,2,0
1905,2019-05-16 14:45:00,79,70.9,54,63.8,133,68.0,2,0
1906,2019-05-16 14:50:00,64,70.9,44,63.6,108,67.9,2,0
1907,2019-05-16 14:55:00,65,70.8,45,62.9,110,67.5,2,0
1908,2019-05-16 15:00:00,46,70.6,33,61.7,79,66.9,2,0
1909,2019-05-16 15:05:00,63,70.3,44,60.3,107,66.2,2,0
1910,2019-05-16 15:10:00,57,70.2,40,59.3,97,65.7,2,0
1911,2019-05-16 15:15:00,80,70.7,54,62.3,134,67.3,2,0
1912,2019-05-16 15:20:00,67,70.8,46,63.0,113,67.6,2,0
1913,2019-05-16 15:25:00,59,71.0,42,64.0,101,68.1,2,0
1914,2019-05-16 15:30:00,67,70.7,46,62.2,113,67.2,2,0
1915,2019-05-16 15:35:00,50,70.9,36,63.4,86,67.8,2,0
1916,2019-05-16 15:40:00,83,70.6,56,61.9,139,67.1,2,0
1917,2019-05-16 15:45:00,77,70.5,53,61.2,130,66.7,2,0
1918,2019-05-16 15:50:00,68,70.8,47,62.8,115,67.5,2,0
1919,2019-05-16 15:55:00,66,70.6,46,62.1,112,67.1,2,0
1920,2019-05-16 16:00:00,58,70.5,41,61.1,99,66.6,2,0
1921,2019-05-16 16:05:00,59,70.4,42,60.9,101,66.5,2,0
1922,2019-05-16 16:10:00,59,70.2,42,59.3,101,65.7,2,0
1923,2019-05-16 16:15:00,67,70.4,46,60.5,113,66.4,2,0
1924,2019-05-16 16:20:00,52,70.3,37,60.0,89,66.0,2,0
1925,2019-05-16 16:25:00,57,70.4,40,60.7,97,66.4,2,0
1926,2019-05-16 16:30:00,76,70.5,52,61.2,128,66.7,2,0
1927,2019-05-16 16:35:00,76,70.4,52,61.0,128,66.6,2,0
1928,2019-05-16 16:40:00,120,70.5,80,61.1,200,66.7,2,0
1929,2019-05-16 16:45:00,75,70.6,51,61.6,126,67.0,2,0
1930,2019-05-16 16:50:00,59,70.7,42,62.6,101,67.3,2,0
1931,2019-05-16 16:55:00,67,70.7,46,62.4,113,67.3,2,0
1932,2019-05-16 17:00:00,59,70.6,42,61.7,101,66.9,2,0
1933,2019-05-16 17:05:00,55,70.4,39,60.7,94,66.4,2,0
1934,2019-05-16 17:10:00,72,70.3,49,60.3,121,66.3,2,0
1935,2019-05-16 17:15:00,86,70.4,59,60.6,145,66.4,2,0
1936,2019-05-16 17:20:00,84,70.6,57,62.2,141,67.2,2,0
1937,2019-05-16 17:25:00,72,70.5,49,61.5,121,66.9,2,0
1938,2019-05-16 17:30:00,47,70.7,34,62.7,81,67.3,2,0
1939,2019-05-16 17:35:00,71,70.7,49,62.3,120,67.2,2,0
1940,2019-05-16 17:40:00,70,70.7,48,62.7,118,67.5,2,0
1941,2019-05-16 17:45:00,70,70.8,48,62.9,118,67.6,2,0
1942,2019-05-16 17:50:00,32,70.5,25,61.4,57,66.5,2,0
1943,2019-05-16 17:55:00,75,70.5,51,61.1,126,66.7,2,0
1944,2019-05-16 18:00:00,54,70.6,38,62.0,92,67.1,2,0
1945,2019-05-16 18:05:00,64,70.5,44,61.2,108,66.7,2,0
1946,2019-05-16 18:10:00,37,70.7,27,62.6,64,67.3,2,0
1947,2019-05-16 18:15:00,65,70.5,45,61.4,110,66.8,2,0
1948,2019-05-16 18:20:00,46,70.5,33,61.3,79,66.7,2,0
1949,2019-05-16 18:25:00,59,70.7,42,62.3,101,67.2,2,0
1950,2019-05-16 18:30:00,59,70.8,42,63.2,101,67.7,2,0
1951,2019-05-16 18:35:00,59,70.8,42,63.1,101,67.6,2,0
1952,2019-05-16 18:40:00,31,70.8,24,63.1,55,67.5,2,0
1953,2019-05-16 18:45:00,46,70.9,33,63.6,79,67.8,2,0
1954,2019-05-16 18:50:00,49,70.8,35,63.1,84,67.6,2,0
1955,2019-05-16 18:55:00,61,71.0,42,64.0,103,68.1,2,0
1956,2019-05-16 19:00:00,57,70.6,40,62.0,97,67.1,2,0
1957,2019-05-16 19:05:00,49,70.7,35,62.6,84,67.4,2,0
1958,2019-05-16 19:10:00,30,70.7,23,62.5,53,67.2,2,0
1959,2019-05-16 19:15:00,48,70.8,34,63.2,82,67.7,2,0
1960,2019-05-16 19:20:00,29,70.9,22,63.4,51,67.6,2,0
1961,2019-05-16 19:25:00,32,70.9,25,63.7,57,67.8,2,0
1962,2019-05-16 19:30:00,43,70.9,31,63.5,74,67.8,2,0
1963,2019-05-16 19:35:00,26,70.7,20,62.4,46,67.1,2,0
1964,2019-05-16 19:40:00,36,70.8,27,62.8,63,67.3,2,0
1965,2019-05-16 19:45:00,27,70.6,21,61.6,48,66.7,2,0
1966,2019-05-16 19:50:00,44,70.6,32,62.2,76,67.1,2,0
1967,2019-05-16 19:55:00,22,70.6,18,62.2,40,66.8,2,0
1968,2019-05-16 20:00:00,30,70.6,23,61.6,53,66.7,2,0
1969,2019-05-16 20:05:00,27,70.7,21,62.2,48,67.0,2,0
1970,2019-05-16 20:10:00,17,70.7,15,62.5,32,66.8,2,0
1971,2019-05-16 20:15:00,11,70.7,11,62.5,22,66.6,2,0
1972,2019-05-16 20:20:00,18,70.2,15,59.4,33,65.3,2,0
1973,2019-05-16 20:25:00,23,70.3,19,60.2,42,65.8,2,0
1974,2019-05-16 20:30:00,30,70.6,23,61.8,53,66.8,2,0
1975,2019-05-16 20:35:00,18,70.7,15,62.3,33,66.9,2,0
1976,2019-05-16 20:40:00,89,70.1,79,64.1,168,67.3,2,0
1977,2019-05-16 20:45:00,17,70.7,15,62.2,32,66.7,2,0
1978,2019-05-16 20:50:00,23,70.7,19,62.3,42,66.9,2,0
1979,2019-05-16 20:55:00,25,70.6,20,61.7,45,66.6,2,0
1980,2019-05-16 21:00:00,28,70.7,22,62.6,50,67.1,2,0
1981,2019-05-16 21:05:00,8,70.7,9,62.4,17,66.3,2,0
1982,2019-05-16 21:10:00,28,70.8,22,62.9,50,67.3,2,0
1983,2019-05-16 21:15:00,22,70.7,18,62.3,40,66.9,2,0
1984,2019-05-16 21:20:00,23,70.7,19,62.5,42,67.0,2,0
1985,2019-05-16 21:25:00,7,70.7,8,62.4,15,66.2,2,0
1986,2019-05-16 21:30:00,21,70.5,17,61.0,38,66.2,2,0
1987,2019-05-16 21:35:00,11,70.5,11,61.3,22,65.9,2,0
1988,2019-05-16 21:40:00,21,70.6,17,62.0,38,66.8,2,0
1989,2019-05-16 21:45:00,23,70.7,19,62.3,42,66.9,2,0
1990,2019-05-16 21:50:00,23,70.6,19,62.1,42,66.8,2,0
1991,2019-05-16 21:55:00,14,70.6,13,62.2,27,66.6,2,0
1992,2019-05-16 22:00:00,19,70.7,16,62.3,35,66.8,2,0
1993,2019-05-16 22:05:00,16,70.6,14,61.9,30,66.5,2,0
1994,2019-05-16 22:10:00,12,70.6,12,62.2,24,66.4,2,0
1995,2019-05-16 22:15:00,31,70.8,24,63.1,55,67.4,2,0
1996,2019-05-16 22:20:00,12,70.7,12,62.4,24,66.6,2,0
1997,2019-05-16 22:25:00,21,70.6,17,61.9,38,66.7,2,0
1998,2019-05-16 22:30:00,16,70.7,14,62.3,30,66.7,2,0
1999,2019-05-16 22:35:00,14,70.7,13,62.4,27,66.7,2,0
2000,2019-05-16 22:40:00,17,70.7,15,62.6,32,66.9,2,0
2001,2019-05-16 22:45:00,14,70.7,13,62.6,27,66.8,2,0
2002,2019-05-16 22:50:00,8,70.7,9,62.5,17,66.4,2,0
2003,2019-05-16 22:55:00,12,70.7,12,62.5,24,66.6,2,0
2004,2019-05-16 23:00:00,12,70.6,12,62.0,24,66.3,2,0
2005,2019-05-16 23:05:00,8,70.6,9,62.1,17,66.1,2,0
2006,2019-05-16 23:10:00,13,65.7,3,62.0,16,65.0,2,0
2007,2019-05-16 23:15:00,1,70.6,5,62.0,6,63.4,2,0
2008,2019-05-16 23:20:00,11,70.6,11,62.2,22,66.4,2,0
2009,2019-05-16 23:25:00,8,70.6,9,62.2,17,66.2,2,0
2010,2019-05-16 23:30:00,7,70.7,8,62.3,15,66.2,2,0
2011,2019-05-16 23:35:00,3,70.6,6,62.1,9,64.9,2,0
2012,2019-05-16 23:40:00,5,70.7,8,62.3,13,65.5,2,0
2013,2019-05-16 23:45:00,7,70.7,8,62.2,15,66.2,2,0
2014,2019-05-16 23:50:00,12,66.3,2,62.3,14,65.7,2,0
2015,2019-05-16 23:55:00,4,70.5,7,61.4,11,64.7,2,0
