,5 Minutes,Lane 1 Flow (Veh/5 Minutes),Lane 1 Speed (mph),Lane 2 Flow (Veh/5 Minutes),Lane 2 Speed (mph),Flow (Veh/5 Minutes),Speed (mph),# Lane Points,% Observed
0,2019-05-24 00:00:00,27,71.2,25,65.0,52,68.2,2,0
1,2019-05-24 00:05:00,27,71.0,24,65.0,51,68.2,2,0
2,2019-05-24 00:10:00,26,70.9,24,64.9,50,68.0,2,0
3,2019-05-24 00:15:00,25,70.9,23,64.9,48,68.0,2,0
4,2019-05-24 00:20:00,24,70.8,21,64.8,45,68.0,2,0
5,2019-05-24 00:25:00,22,70.7,19,64.7,41,67.9,2,0
6,2019-05-24 00:30:00,21,70.7,18,64.7,39,67.9,2,0
7,2019-05-24 00:35:00,19,70.7,17,64.7,36,67.9,2,0
8,2019-05-24 00:40:00,18,70.6,17,64.6,35,67.7,2,0
9,2019-05-24 00:45:00,17,70.6,16,64.6,33,67.7,2,0
10,2019-05-24 00:50:00,16,70.6,15,64.6,31,67.7,2,0
11,2019-05-24 00:55:00,16,70.5,14,64.5,30,67.7,2,0
12,2019-05-24 01:00:00,15,70.7,13,64.7,28,67.9,2,0
13,2019-05-24 01:05:00,14,70.7,13,64.7,27,67.8,2,0
14,2019-05-24 01:10:00,14,70.7,13,64.7,27,67.8,2,0
15,2019-05-24 01:15:00,13,70.7,12,64.7,25,67.8,2,0
16,2019-05-24 01:20:00,13,70.6,11,64.6,24,67.9,2,0
17,2019-05-24 01:25:00,12,70.6,11,64.6,23,67.7,2,0
18,2019-05-24 01:30:00,12,70.6,10,64.6,22,67.9,2,0
19,2019-05-24 01:35:00,12,70.6,10,64.6,22,67.9,2,0
20,2019-05-24 01:40:00,11,70.5,10,64.5,21,67.6,2,0
21,2019-05-24 01:45:00,11,70.5,10,64.5,21,67.6,2,0
22,2019-05-24 01:50:00,11,70.5,9,64.5,20,67.8,2,0
23,2019-05-24 01:55:00,10,70.5,9,64.5,19,67.7,2,0
24,2019-05-24 02:00:00,9,70.5,9,64.5,18,67.5,2,0
25,2019-05-24 02:05:00,10,70.6,9,64.6,19,67.8,2,0
26,2019-05-24 02:10:00,10,70.6,9,64.6,19,67.8,2,0
27,2019-05-24 02:15:00,9,70.6,9,64.6,18,67.6,2,0
28,2019-05-24 02:20:00,9,70.5,9,64.5,18,67.5,2,0
29,2019-05-24 02:25:00,9,70.5,9,64.5,18,67.5,2,0
30,2019-05-24 02:30:00,9,70.5,8,64.5,17,67.7,2,0
31,2019-05-24 02:35:00,9,70.5,9,64.5,18,67.5,2,0
32,2019-05-24 02:40:00,9,70.5,9,64.5,18,67.5,2,0
33,2019-05-24 02:45:00,9,70.5,9,64.5,18,67.5,2,0
34,2019-05-24 02:50:00,9,70.5,8,64.5,17,67.7,2,0
35,2019-05-24 02:55:00,9,70.5,8,64.5,17,67.7,2,0
36,2019-05-24 03:00:00,8,70.5,8,64.5,16,67.5,2,0
37,2019-05-24 03:05:00,8,70.4,8,64.4,16,67.4,2,0
38,2019-05-24 03:10:00,9,70.4,8,64.4,17,67.6,2,0
39,2019-05-24 03:15:00,9,70.4,8,64.4,17,67.6,2,0
40,2019-05-24 03:20:00,9,70.4,9,64.4,18,67.4,2,0
41,2019-05-24 03:25:00,9,70.4,9,64.4,18,67.4,2,0
42,2019-05-24 03:30:00,11,70.4,9,64.4,20,67.7,2,0
43,2019-05-24 03:35:00,12,70.4,10,64.4,22,67.7,2,0
44,2019-05-24 03:40:00,13,70.5,11,64.5,24,67.8,2,0
45,2019-05-24 03:45:00,13,70.5,12,64.5,25,67.6,2,0
46,2019-05-24 03:50:00,14,70.5,12,64.5,26,67.7,2,0
47,2019-05-24 03:55:00,14,70.5,12,64.5,26,67.7,2,0
48,2019-05-24 04:00:00,13,70.4,12,64.4,25,67.5,2,0
49,2019-05-24 04:05:00,14,70.4,13,64.4,27,67.5,2,0
50,2019-05-24 04:10:00,15,70.4,14,64.4,29,67.5,2,0
51,2019-05-24 04:15:00,17,70.4,15,64.4,32,67.6,2,0
52,2019-05-24 04:20:00,18,70.4,17,64.4,35,67.5,2,0
53,2019-05-24 04:25:00,20,70.5,18,64.5,38,67.7,2,0
54,2019-05-24 04:30:00,22,70.6,20,64.6,42,67.7,2,0
55,2019-05-24 04:35:00,24,70.6,22,64.6,46,67.7,2,0
56,2019-05-24 04:40:00,27,70.8,25,64.8,52,67.9,2,0
57,2019-05-24 04:45:00,30,70.8,27,64.8,57,68.0,2,0
58,2019-05-24 04:50:00,32,70.9,28,64.9,60,68.1,2,0
59,2019-05-24 04:55:00,32,70.8,29,64.8,61,67.9,2,0
60,2019-05-24 05:00:00,33,70.7,30,64.7,63,67.8,2,0
61,2019-05-24 05:05:00,36,70.7,32,64.7,68,67.9,2,0
62,2019-05-24 05:10:00,40,70.7,35,64.7,75,67.9,2,0
63,2019-05-24 05:15:00,43,70.6,39,64.6,82,67.7,2,0
64,2019-05-24 05:20:00,46,70.6,42,64.6,88,67.7,2,0
65,2019-05-24 05:25:00,50,70.6,45,64.6,95,67.8,2,0
66,2019-05-24 05:30:00,53,70.6,48,64.6,101,67.7,2,0
67,2019-05-24 05:35:00,58,70.6,52,64.6,110,67.8,2,0
68,2019-05-24 05:40:00,62,70.7,56,64.7,118,67.9,2,0
69,2019-05-24 05:45:00,65,70.9,58,64.9,123,68.1,2,0
70,2019-05-24 05:50:00,66,70.9,60,64.9,126,68.0,2,0
71,2019-05-24 05:55:00,65,70.9,59,64.9,124,68.0,2,0
72,2019-05-24 06:00:00,65,70.0,58,64.0,123,67.2,2,0
73,2019-05-24 06:05:00,68,69.6,62,63.6,130,66.7,2,0
74,2019-05-24 06:10:00,73,69.5,66,63.5,139,66.7,2,0
75,2019-05-24 06:15:00,79,69.5,70,63.5,149,66.7,2,0
76,2019-05-24 06:20:00,83,69.4,74,63.4,157,66.6,2,0
77,2019-05-24 06:25:00,86,69.4,78,63.4,164,66.5,2,0
78,2019-05-24 06:30:00,90,69.4,81,63.4,171,66.6,2,0
79,2019-05-24 06:35:00,94,69.4,84,63.4,178,66.6,2,0
80,2019-05-24 06:40:00,99,69.4,88,63.4,187,66.6,2,0
81,2019-05-24 06:45:00,103,69.5,92,63.5,195,66.7,2,0
82,2019-05-24 06:50:00,103,69.6,92,63.6,195,66.8,2,0
83,2019-05-24 06:55:00,100,69.6,90,63.6,190,66.8,2,0
84,2019-05-24 07:00:00,99,68.9,88,62.9,187,66.1,2,0
85,2019-05-24 07:05:00,101,68.3,91,62.5,192,65.6,2,0
86,2019-05-24 07:10:00,106,68.1,95,62.3,201,65.4,2,0
87,2019-05-24 07:15:00,112,68.1,100,62.3,212,65.4,2,0
88,2019-05-24 07:20:00,115,67.9,103,62.1,218,65.2,2,0
89,2019-05-24 07:25:00,119,67.9,107,62.1,226,65.2,2,0
90,2019-05-24 07:30:00,122,67.8,109,62.0,231,65.1,2,0
91,2019-05-24 07:35:00,126,67.8,113,62.0,239,65.1,2,0
92,2019-05-24 07:40:00,130,67.6,117,61.8,247,64.9,2,0
93,2019-05-24 07:45:00,133,67.6,120,61.8,253,64.8,2,0
94,2019-05-24 07:50:00,133,67.6,119,61.8,252,64.9,2,0
95,2019-05-24 07:55:00,128,67.5,115,61.7,243,64.8,2,0
96,2019-05-24 08:00:00,124,67.4,111,61.6,235,64.7,2,0
97,2019-05-24 08:05:00,123,67.3,111,61.5,234,64.5,2,0
98,2019-05-24 08:10:00,125,67.1,112,61.3,237,64.4,2,0
99,2019-05-24 08:15:00,126,67.0,114,61.2,240,64.2,2,0
100,2019-05-24 08:20:00,126,66.9,114,61.1,240,64.1,2,0
101,2019-05-24 08:25:00,125,66.8,113,61.0,238,64.0,2,0
102,2019-05-24 08:30:00,123,66.6,111,60.8,234,63.8,2,0
103,2019-05-24 08:35:00,124,66.4,112,60.8,236,63.7,2,0
104,2019-05-24 08:40:00,126,66.3,114,60.7,240,63.6,2,0
105,2019-05-24 08:45:00,127,66.2,114,60.6,241,63.6,2,0
106,2019-05-24 08:50:00,124,66.2,112,60.6,236,63.5,2,0
107,2019-05-24 08:55:00,119,66.1,107,60.5,226,63.5,2,0
108,2019-05-24 09:00:00,117,66.1,105,60.5,222,63.5,2,0
109,2019-05-24 09:05:00,119,66.1,107,60.5,226,63.5,2,0
110,2019-05-24 09:10:00,120,66.0,107,60.4,227,63.4,2,0
111,2019-05-24 09:15:00,121,65.9,109,60.3,230,63.2,2,0
112,2019-05-24 09:20:00,122,65.9,110,60.3,232,63.2,2,0
113,2019-05-24 09:25:00,123,65.9,111,60.3,234,63.2,2,0
114,2019-05-24 09:30:00,124,66.0,111,60.4,235,63.4,2,0
115,2019-05-24 09:35:00,125,65.9,112,60.3,237,63.3,2,0
116,2019-05-24 09:40:00,125,66.0,113,60.4,238,63.3,2,0
117,2019-05-24 09:45:00,127,66.0,114,60.4,241,63.4,2,0
118,2019-05-24 09:50:00,126,66.0,114,60.4,240,63.3,2,0
119,2019-05-24 09:55:00,124,66.1,111,60.5,235,63.5,2,0
120,2019-05-24 10:00:00,121,66.2,108,60.6,229,63.6,2,0
121,2019-05-24 10:05:00,121,66.1,108,60.5,229,63.5,2,0
122,2019-05-24 10:10:00,122,66.1,110,60.5,232,63.4,2,0
123,2019-05-24 10:15:00,124,66.2,111,60.6,235,63.6,2,0
124,2019-05-24 10:20:00,124,66.2,112,60.6,236,63.5,2,0
125,2019-05-24 10:25:00,123,66.3,111,60.7,234,63.6,2,0
126,2019-05-24 10:30:00,124,66.3,111,60.7,235,63.7,2,0
127,2019-05-24 10:35:00,124,66.3,111,60.7,235,63.7,2,0
128,2019-05-24 10:40:00,126,66.3,114,60.7,240,63.6,2,0
129,2019-05-24 10:45:00,128,66.4,114,60.8,242,63.8,2,0
130,2019-05-24 10:50:00,127,66.4,114,60.8,241,63.8,2,0
131,2019-05-24 10:55:00,125,66.4,113,60.8,238,63.7,2,0
132,2019-05-24 11:00:00,123,66.3,110,60.7,233,63.7,2,0
133,2019-05-24 11:05:00,124,66.3,112,60.7,236,63.6,2,0
134,2019-05-24 11:10:00,126,66.2,113,60.6,239,63.6,2,0
135,2019-05-24 11:15:00,128,66.3,115,60.7,243,63.7,2,0
136,2019-05-24 11:20:00,129,66.3,115,60.7,244,63.7,2,0
137,2019-05-24 11:25:00,129,66.3,115,60.7,244,63.7,2,0
138,2019-05-24 11:30:00,129,66.3,115,60.7,244,63.7,2,0
139,2019-05-24 11:35:00,130,66.3,116,60.7,246,63.7,2,0
140,2019-05-24 11:40:00,131,66.3,118,60.7,249,63.6,2,0
141,2019-05-24 11:45:00,132,66.4,118,60.8,250,63.8,2,0
142,2019-05-24 11:50:00,132,66.4,118,60.8,250,63.8,2,0
143,2019-05-24 11:55:00,131,66.4,117,60.8,248,63.8,2,0
144,2019-05-24 12:00:00,129,66.3,115,60.7,244,63.7,2,0
145,2019-05-24 12:05:00,131,66.2,117,60.6,248,63.6,2,0
146,2019-05-24 12:10:00,132,66.1,118,60.5,250,63.5,2,0
147,2019-05-24 12:15:00,134,66.1,120,60.5,254,63.5,2,0
148,2019-05-24 12:20:00,133,66.1,120,60.5,253,63.4,2,0
149,2019-05-24 12:25:00,133,66.2,119,60.6,252,63.6,2,0
150,2019-05-24 12:30:00,133,66.2,120,60.6,253,63.5,2,0
151,2019-05-24 12:35:00,134,66.2,121,60.6,255,63.5,2,0
152,2019-05-24 12:40:00,135,66.3,122,60.7,257,63.6,2,0
153,2019-05-24 12:45:00,135,66.2,122,60.6,257,63.5,2,0
154,2019-05-24 12:50:00,134,66.3,121,60.7,255,63.6,2,0
155,2019-05-24 12:55:00,133,66.4,119,60.8,252,63.8,2,0
156,2019-05-24 13:00:00,132,66.2,119,60.6,251,63.5,2,0
157,2019-05-24 13:05:00,132,66.1,119,60.5,251,63.4,2,0
158,2019-05-24 13:10:00,134,66.1,120,60.5,254,63.5,2,0
159,2019-05-24 13:15:00,135,66.0,122,60.4,257,63.3,2,0
160,2019-05-24 13:20:00,138,66.0,123,60.4,261,63.4,2,0
161,2019-05-24 13:25:00,136,66.0,122,60.4,258,63.4,2,0
162,2019-05-24 13:30:00,136,66.0,123,60.4,259,63.3,2,0
163,2019-05-24 13:35:00,138,66.0,123,60.4,261,63.4,2,0
164,2019-05-24 13:40:00,139,66.0,124,60.4,263,63.4,2,0
165,2019-05-24 13:45:00,140,66.0,125,60.4,265,63.4,2,0
166,2019-05-24 13:50:00,140,66.0,126,60.4,266,63.3,2,0
167,2019-05-24 13:55:00,141,66.0,126,60.4,267,63.4,2,0
168,2019-05-24 14:00:00,140,65.9,125,60.3,265,63.3,2,0
169,2019-05-24 14:05:00,142,65.8,128,60.2,270,63.1,2,0
170,2019-05-24 14:10:00,145,65.8,130,60.2,275,63.2,2,0
171,2019-05-24 14:15:00,146,65.7,131,60.1,277,63.1,2,0
172,2019-05-24 14:20:00,147,65.6,132,60.0,279,63.0,2,0
173,2019-05-24 14:25:00,146,65.7,132,60.1,278,63.0,2,0
174,2019-05-24 14:30:00,146,65.6,132,60.0,278,62.9,2,0
175,2019-05-24 14:35:00,149,65.7,134,60.1,283,63.0,2,0
176,2019-05-24 14:40:00,151,65.6,135,60.0,286,63.0,2,0
177,2019-05-24 14:45:00,151,65.6,135,60.0,286,63.0,2,0
178,2019-05-24 14:50:00,150,65.6,134,60.0,284,63.0,2,0
179,2019-05-24 14:55:00,147,65.7,132,60.1,279,63.1,2,0
180,2019-05-24 15:00:00,145,65.6,130,60.0,275,63.0,2,0
181,2019-05-24 15:05:00,144,65.5,130,59.9,274,62.8,2,0
182,2019-05-24 15:10:00,148,65.5,132,59.9,280,62.9,2,0
183,2019-05-24 15:15:00,148,65.4,133,59.8,281,62.7,2,0
184,2019-05-24 15:20:00,148,65.4,133,59.8,281,62.7,2,0
185,2019-05-24 15:25:00,147,65.4,132,59.8,279,62.8,2,0
186,2019-05-24 15:30:00,147,65.5,132,59.9,279,62.9,2,0
187,2019-05-24 15:35:00,148,65.5,133,59.9,281,62.8,2,0
188,2019-05-24 15:40:00,150,65.5,134,59.9,284,62.9,2,0
189,2019-05-24 15:45:00,151,65.5,135,59.9,286,62.9,2,0
190,2019-05-24 15:50:00,149,65.4,134,59.8,283,62.7,2,0
191,2019-05-24 15:55:00,147,65.5,132,59.9,279,62.9,2,0
192,2019-05-24 16:00:00,145,65.6,131,60.0,276,62.9,2,0
193,2019-05-24 16:05:00,146,65.7,132,60.1,278,63.0,2,0
194,2019-05-24 16:10:00,148,65.7,133,60.1,281,63.1,2,0
195,2019-05-24 16:15:00,149,65.7,134,60.1,283,63.0,2,0
196,2019-05-24 16:20:00,149,65.9,134,60.3,283,63.2,2,0
197,2019-05-24 16:25:00,148,65.9,132,60.3,280,63.3,2,0
198,2019-05-24 16:30:00,148,66.0,132,60.4,280,63.4,2,0
199,2019-05-24 16:35:00,150,66.1,134,60.5,284,63.5,2,0
200,2019-05-24 16:40:00,151,66.0,135,60.4,286,63.4,2,0
201,2019-05-24 16:45:00,150,66.1,134,60.5,284,63.5,2,0
202,2019-05-24 16:50:00,149,66.2,134,60.6,283,63.6,2,0
203,2019-05-24 16:55:00,147,66.3,132,60.7,279,63.7,2,0
204,2019-05-24 17:00:00,145,66.6,131,60.8,276,63.8,2,0
205,2019-05-24 17:05:00,148,66.6,133,60.8,281,63.9,2,0
206,2019-05-24 17:10:00,152,66.4,136,60.8,288,63.8,2,0
207,2019-05-24 17:15:00,153,66.6,138,60.8,291,63.8,2,0
208,2019-05-24 17:20:00,152,66.6,136,60.8,288,63.9,2,0
209,2019-05-24 17:25:00,150,66.7,134,60.9,284,64.0,2,0
210,2019-05-24 17:30:00,147,66.8,132,61.0,279,64.1,2,0
211,2019-05-24 17:35:00,145,66.9,131,61.1,276,64.1,2,0
212,2019-05-24 17:40:00,145,67.0,131,61.2,276,64.2,2,0
213,2019-05-24 17:45:00,144,67.1,130,61.3,274,64.3,2,0
214,2019-05-24 17:50:00,142,67.2,127,61.4,269,64.5,2,0
215,2019-05-24 17:55:00,139,67.4,125,61.6,264,64.7,2,0
216,2019-05-24 18:00:00,138,67.6,123,61.8,261,64.9,2,0
217,2019-05-24 18:05:00,138,67.8,123,62.0,261,65.1,2,0
218,2019-05-24 18:10:00,138,67.9,123,62.1,261,65.2,2,0
219,2019-05-24 18:15:00,136,68.0,122,62.2,258,65.3,2,0
220,2019-05-24 18:20:00,135,68.2,122,62.4,257,65.4,2,0
221,2019-05-24 18:25:00,134,68.3,120,62.5,254,65.6,2,0
222,2019-05-24 18:30:00,133,68.5,119,62.7,252,65.8,2,0
223,2019-05-24 18:35:00,132,68.5,118,62.7,250,65.8,2,0
224,2019-05-24 18:40:00,131,68.7,117,62.9,248,66.0,2,0
225,2019-05-24 18:45:00,130,68.7,116,62.9,246,66.0,2,0
226,2019-05-24 18:50:00,127,69.0,114,63.0,241,66.2,2,0
227,2019-05-24 18:55:00,125,69.2,113,63.2,238,66.3,2,0
228,2019-05-24 19:00:00,123,69.5,111,63.5,234,66.7,2,0
229,2019-05-24 19:05:00,122,69.6,110,63.6,232,66.8,2,0
230,2019-05-24 19:10:00,122,69.7,110,63.7,232,66.9,2,0
231,2019-05-24 19:15:00,121,69.8,109,63.8,230,67.0,2,0
232,2019-05-24 19:20:00,120,69.9,108,63.9,228,67.1,2,0
233,2019-05-24 19:25:00,117,70.0,106,64.0,223,67.1,2,0
234,2019-05-24 19:30:00,116,70.1,104,64.1,220,67.3,2,0
235,2019-05-24 19:35:00,114,70.2,103,64.2,217,67.4,2,0
236,2019-05-24 19:40:00,113,70.2,102,64.2,215,67.4,2,0
237,2019-05-24 19:45:00,111,70.3,99,64.3,210,67.5,2,0
238,2019-05-24 19:50:00,110,70.3,98,64.3,208,67.5,2,0
239,2019-05-24 19:55:00,106,70.3,96,64.3,202,67.4,2,0
240,2019-05-24 20:00:00,104,70.4,93,64.4,197,67.6,2,0
241,2019-05-24 20:05:00,102,70.5,92,64.5,194,67.7,2,0
242,2019-05-24 20:10:00,102,70.5,91,64.5,193,67.7,2,0
243,2019-05-24 20:15:00,102,70.4,91,64.4,193,67.6,2,0
244,2019-05-24 20:20:00,100,70.4,90,64.4,190,67.6,2,0
245,2019-05-24 20:25:00,99,70.4,88,64.4,187,67.6,2,0
246,2019-05-24 20:30:00,96,70.3,87,64.3,183,67.4,2,0
247,2019-05-24 20:35:00,95,70.3,86,64.3,181,67.4,2,0
248,2019-05-24 20:40:00,94,70.2,85,64.2,179,67.4,2,0
249,2019-05-24 20:45:00,92,70.1,83,64.1,175,67.3,2,0
250,2019-05-24 20:50:00,91,70.0,82,64.0,173,67.2,2,0
251,2019-05-24 20:55:00,90,69.9,81,63.9,171,67.1,2,0
252,2019-05-24 21:00:00,89,70.2,79,64.2,168,67.4,2,0
253,2019-05-24 21:05:00,89,70.3,79,64.3,168,67.5,2,0
254,2019-05-24 21:10:00,90,70.4,81,64.4,171,67.6,2,0
255,2019-05-24 21:15:00,90,70.4,80,64.4,170,67.6,2,0
256,2019-05-24 21:20:00,89,70.4,80,64.4,169,67.6,2,0
257,2019-05-24 21:25:00,88,70.4,79,64.4,167,67.6,2,0
258,2019-05-24 21:30:00,86,70.4,77,64.4,163,67.6,2,0
259,2019-05-24 21:35:00,84,70.5,76,64.5,160,67.7,2,0
260,2019-05-24 21:40:00,84,70.5,75,64.5,159,67.7,2,0
261,2019-05-24 21:45:00,83,70.6,74,64.6,157,67.8,2,0
262,2019-05-24 21:50:00,81,70.7,72,64.7,153,67.9,2,0
263,2019-05-24 21:55:00,79,70.8,71,64.8,150,68.0,2,0
264,2019-05-24 22:00:00,77,70.7,70,64.7,147,67.8,2,0
265,2019-05-24 22:05:00,77,70.6,69,64.6,146,67.8,2,0
266,2019-05-24 22:10:00,77,70.7,70,64.7,147,67.8,2,0
267,2019-05-24 22:15:00,77,70.7,69,64.7,146,67.9,2,0
268,2019-05-24 22:20:00,74,70.7,67,64.7,141,67.9,2,0
269,2019-05-24 22:25:00,72,70.8,65,64.8,137,68.0,2,0
270,2019-05-24 22:30:00,70,70.8,63,64.8,133,68.0,2,0
271,2019-05-24 22:35:00,69,70.9,62,64.9,131,68.1,2,0
272,2019-05-24 22:40:00,68,71.0,61,65.0,129,68.2,2,0
273,2019-05-24 22:45:00,66,71.0,60,65.0,126,68.1,2,0
274,2019-05-24 22:50:00,64,71.0,58,65.0,122,68.1,2,0
275,2019-05-24 22:55:00,62,71.2,55,65.0,117,68.3,2,0
276,2019-05-24 23:00:00,59,70.9,53,64.9,112,68.1,2,0
277,2019-05-24 23:05:00,57,70.8,52,64.8,109,67.9,2,0
278,2019-05-24 23:10:00,57,70.8,51,64.8,108,68.0,2,0
279,2019-05-24 23:15:00,56,70.7,50,64.7,106,67.9,2,0
280,2019-05-24 23:20:00,54,70.7,48,64.7,102,67.9,2,0
281,2019-05-24 23:25:00,52,70.7,46,64.7,98,67.9,2,0
282,2019-05-24 23:30:00,50,70.8,45,64.8,95,68.0,2,0
283,2019-05-24 23:35:00,50,70.8,44,64.8,94,68.0,2,0
284,2019-05-24 23:40:00,47,70.8,43,64.8,90,67.9,2,0
285,2019-05-24 23:45:00,46,70.8,41,64.8,87,68.0,2,0
286,2019-05-24 23:50:00,44,70.9,40,64.9,84,68.0,2,0
287,2019-05-24 23:55:00,42,70.9,37,64.9,79,68.1,2,0
288,2019-05-25 00:00:00,39,71.2,35,65.0,74,68.3,2,0
289,2019-05-25 00:05:00,38,71.0,34,65.0,72,68.2,2,0
290,2019-05-25 00:10:00,37,70.9,33,64.9,70,68.1,2,0
291,2019-05-25 00:15:00,35,70.8,32,64.8,67,67.9,2,0
292,2019-05-25 00:20:00,34,70.8,30,64.8,64,68.0,2,0
293,2019-05-25 00:25:00,32,70.8,28,64.8,60,68.0,2,0
294,2019-05-25 00:30:00,30,70.8,26,64.8,56,68.0,2,0
295,2019-05-25 00:35:00,28,70.8,26,64.8,54,67.9,2,0
296,2019-05-25 00:40:00,27,70.8,25,64.8,52,67.9,2,0
297,2019-05-25 00:45:00,26,70.7,24,64.7,50,67.8,2,0
298,2019-05-25 00:50:00,25,70.7,22,64.7,47,67.9,2,0
299,2019-05-25 00:55:00,24,70.7,21,64.7,45,67.9,2,0
300,2019-05-25 01:00:00,23,70.8,20,64.8,43,68.0,2,0
301,2019-05-25 01:05:00,22,70.8,19,64.8,41,68.0,2,0
302,2019-05-25 01:10:00,21,70.8,19,64.8,40,68.0,2,0
303,2019-05-25 01:15:00,20,70.8,18,64.8,38,68.0,2,0
304,2019-05-25 01:20:00,19,70.7,18,64.7,37,67.8,2,0
305,2019-05-25 01:25:00,18,70.7,17,64.7,35,67.8,2,0
306,2019-05-25 01:30:00,18,70.7,17,64.7,35,67.8,2,0
307,2019-05-25 01:35:00,17,70.7,16,64.7,33,67.8,2,0
308,2019-05-25 01:40:00,17,70.7,15,64.7,32,67.9,2,0
309,2019-05-25 01:45:00,17,70.7,15,64.7,32,67.9,2,0
310,2019-05-25 01:50:00,16,70.6,15,64.6,31,67.7,2,0
311,2019-05-25 01:55:00,15,70.7,14,64.7,29,67.8,2,0
312,2019-05-25 02:00:00,15,70.7,14,64.7,29,67.8,2,0
313,2019-05-25 02:05:00,15,70.7,14,64.7,29,67.8,2,0
314,2019-05-25 02:10:00,15,70.7,13,64.7,28,67.9,2,0
315,2019-05-25 02:15:00,14,70.7,13,64.7,27,67.8,2,0
316,2019-05-25 02:20:00,14,70.7,12,64.7,26,67.9,2,0
317,2019-05-25 02:25:00,13,70.7,12,64.7,25,67.8,2,0
318,2019-05-25 02:30:00,13,70.7,11,64.7,24,68.0,2,0
319,2019-05-25 02:35:00,13,70.7,11,64.7,24,68.0,2,0
320,2019-05-25 02:40:00,12,70.7,11,64.7,23,67.8,2,0
321,2019-05-25 02:45:00,12,70.7,10,64.7,22,68.0,2,0
322,2019-05-25 02:50:00,11,70.7,10,64.7,21,67.8,2,0
323,2019-05-25 02:55:00,11,70.6,9,64.6,20,67.9,2,0
324,2019-05-25 03:00:00,11,70.7,9,64.7,20,68.0,2,0
325,2019-05-25 03:05:00,10,70.7,9,64.7,19,67.9,2,0
326,2019-05-25 03:10:00,10,70.7,9,64.7,19,67.9,2,0
327,2019-05-25 03:15:00,10,70.7,9,64.7,19,67.9,2,0
328,2019-05-25 03:20:00,10,70.7,9,64.7,19,67.9,2,0
329,2019-05-25 03:25:00,9,70.7,9,64.7,18,67.7,2,0
330,2019-05-25 03:30:00,10,70.7,9,64.7,19,67.9,2,0
331,2019-05-25 03:35:00,10,70.6,9,64.6,19,67.8,2,0
332,2019-05-25 03:40:00,11,70.6,9,64.6,20,67.9,2,0
333,2019-05-25 03:45:00,11,70.6,9,64.6,20,67.9,2,0
334,2019-05-25 03:50:00,10,70.6,9,64.6,19,67.8,2,0
335,2019-05-25 03:55:00,10,70.6,9,64.6,19,67.8,2,0
336,2019-05-25 04:00:00,9,70.6,9,64.6,18,67.6,2,0
337,2019-05-25 04:05:00,10,70.5,9,64.5,19,67.7,2,0
338,2019-05-25 04:10:00,10,70.6,9,64.6,19,67.8,2,0
339,2019-05-25 04:15:00,11,70.6,10,64.6,21,67.7,2,0
340,2019-05-25 04:20:00,12,70.7,10,64.7,22,68.0,2,0
341,2019-05-25 04:25:00,12,70.6,11,64.6,23,67.7,2,0
342,2019-05-25 04:30:00,13,70.7,11,64.7,24,68.0,2,0
343,2019-05-25 04:35:00,14,70.7,13,64.7,27,67.8,2,0
344,2019-05-25 04:40:00,15,70.7,14,64.7,29,67.8,2,0
345,2019-05-25 04:45:00,16,70.7,15,64.7,31,67.8,2,0
346,2019-05-25 04:50:00,17,70.7,15,64.7,32,67.9,2,0
347,2019-05-25 04:55:00,17,70.7,15,64.7,32,67.9,2,0
348,2019-05-25 05:00:00,17,70.7,15,64.7,32,67.9,2,0
349,2019-05-25 05:05:00,18,70.7,16,64.7,34,67.9,2,0
350,2019-05-25 05:10:00,19,70.6,18,64.6,37,67.7,2,0
351,2019-05-25 05:15:00,22,70.7,19,64.7,41,67.9,2,0
352,2019-05-25 05:20:00,23,70.7,21,64.7,44,67.8,2,0
353,2019-05-25 05:25:00,25,70.8,22,64.8,47,68.0,2,0
354,2019-05-25 05:30:00,26,70.7,23,64.7,49,67.9,2,0
355,2019-05-25 05:35:00,28,70.8,26,64.8,54,67.9,2,0
356,2019-05-25 05:40:00,31,70.8,28,64.8,59,68.0,2,0
357,2019-05-25 05:45:00,32,70.9,28,64.9,60,68.1,2,0
358,2019-05-25 05:50:00,32,70.9,29,64.9,61,68.0,2,0
359,2019-05-25 05:55:00,31,70.9,28,64.9,59,68.1,2,0
360,2019-05-25 06:00:00,31,70.8,28,64.8,59,68.0,2,0
361,2019-05-25 06:05:00,33,70.7,29,64.7,62,67.9,2,0
362,2019-05-25 06:10:00,36,70.7,32,64.7,68,67.9,2,0
363,2019-05-25 06:15:00,38,70.8,35,64.8,73,67.9,2,0
364,2019-05-25 06:20:00,41,70.8,37,64.8,78,68.0,2,0
365,2019-05-25 06:25:00,44,70.8,39,64.8,83,68.0,2,0
366,2019-05-25 06:30:00,46,70.9,42,64.9,88,68.0,2,0
367,2019-05-25 06:35:00,50,70.9,44,64.9,94,68.1,2,0
368,2019-05-25 06:40:00,53,70.9,48,64.9,101,68.1,2,0
369,2019-05-25 06:45:00,56,71.0,50,65.0,106,68.2,2,0
370,2019-05-25 06:50:00,55,71.0,50,65.0,105,68.1,2,0
371,2019-05-25 06:55:00,54,71.2,49,65.0,103,68.2,2,0
372,2019-05-25 07:00:00,54,70.8,48,64.8,102,68.0,2,0
373,2019-05-25 07:05:00,56,70.7,50,64.7,106,67.9,2,0
374,2019-05-25 07:10:00,59,70.7,53,64.7,112,67.9,2,0
375,2019-05-25 07:15:00,63,70.7,57,64.7,120,67.9,2,0
376,2019-05-25 07:20:00,65,70.7,59,64.7,124,67.8,2,0
377,2019-05-25 07:25:00,68,70.7,61,64.7,129,67.9,2,0
378,2019-05-25 07:30:00,70,70.7,63,64.7,133,67.9,2,0
379,2019-05-25 07:35:00,74,70.7,67,64.7,141,67.9,2,0
380,2019-05-25 07:40:00,79,70.7,71,64.7,150,67.9,2,0
381,2019-05-25 07:45:00,82,70.7,74,64.7,156,67.9,2,0
382,2019-05-25 07:50:00,83,70.7,75,64.7,158,67.9,2,0
383,2019-05-25 07:55:00,81,70.7,73,64.7,154,67.9,2,0
384,2019-05-25 08:00:00,80,70.5,71,64.5,151,67.7,2,0
385,2019-05-25 08:05:00,81,70.4,72,64.4,153,67.6,2,0
386,2019-05-25 08:10:00,83,70.3,75,64.3,158,67.5,2,0
387,2019-05-25 08:15:00,86,70.3,78,64.3,164,67.4,2,0
388,2019-05-25 08:20:00,90,70.3,81,64.3,171,67.5,2,0
389,2019-05-25 08:25:00,92,70.3,83,64.3,175,67.5,2,0
390,2019-05-25 08:30:00,95,70.3,85,64.3,180,67.5,2,0
391,2019-05-25 08:35:00,99,70.3,88,64.3,187,67.5,2,0
392,2019-05-25 08:40:00,102,70.3,91,64.3,193,67.5,2,0
393,2019-05-25 08:45:00,106,70.2,95,64.2,201,67.4,2,0
394,2019-05-25 08:50:00,106,70.2,95,64.2,201,67.4,2,0
395,2019-05-25 08:55:00,103,70.2,93,64.2,196,67.4,2,0
396,2019-05-25 09:00:00,102,70.0,91,64.0,193,67.2,2,0
397,2019-05-25 09:05:00,102,69.8,91,63.8,193,67.0,2,0
398,2019-05-25 09:10:00,105,69.7,95,63.7,200,66.8,2,0
399,2019-05-25 09:15:00,109,69.5,98,63.5,207,66.7,2,0
400,2019-05-25 09:20:00,112,69.4,101,63.4,213,66.6,2,0
401,2019-05-25 09:25:00,115,69.4,103,63.4,218,66.6,2,0
402,2019-05-25 09:30:00,117,69.4,105,63.4,222,66.6,2,0
403,2019-05-25 09:35:00,120,69.3,107,63.3,227,66.5,2,0
404,2019-05-25 09:40:00,123,69.3,110,63.3,233,66.5,2,0
405,2019-05-25 09:45:00,126,69.2,114,63.2,240,66.3,2,0
406,2019-05-25 09:50:00,127,69.2,114,63.2,241,66.4,2,0
407,2019-05-25 09:55:00,124,69.2,112,63.2,236,66.4,2,0
408,2019-05-25 10:00:00,122,69.0,110,63.0,232,66.2,2,0
409,2019-05-25 10:05:00,122,68.7,110,62.9,232,66.0,2,0
410,2019-05-25 10:10:00,124,68.6,112,62.8,236,65.8,2,0
411,2019-05-25 10:15:00,126,68.6,113,62.8,239,65.9,2,0
412,2019-05-25 10:20:00,129,68.5,116,62.7,245,65.8,2,0
413,2019-05-25 10:25:00,130,68.5,117,62.7,247,65.8,2,0
414,2019-05-25 10:30:00,130,68.5,116,62.7,246,65.8,2,0
415,2019-05-25 10:35:00,131,68.5,117,62.7,248,65.8,2,0
416,2019-05-25 10:40:00,133,68.4,119,62.6,252,65.7,2,0
417,2019-05-25 10:45:00,135,68.4,121,62.6,256,65.7,2,0
418,2019-05-25 10:50:00,135,68.4,121,62.6,256,65.7,2,0
419,2019-05-25 10:55:00,133,68.4,119,62.6,252,65.7,2,0
420,2019-05-25 11:00:00,132,68.3,119,62.5,251,65.6,2,0
421,2019-05-25 11:05:00,132,68.3,119,62.5,251,65.6,2,0
422,2019-05-25 11:10:00,134,68.2,120,62.4,254,65.5,2,0
423,2019-05-25 11:15:00,134,68.2,121,62.4,255,65.4,2,0
424,2019-05-25 11:20:00,135,68.2,122,62.4,257,65.4,2,0
425,2019-05-25 11:25:00,136,68.2,122,62.4,258,65.5,2,0
426,2019-05-25 11:30:00,136,68.2,123,62.4,259,65.4,2,0
427,2019-05-25 11:35:00,136,68.2,123,62.4,259,65.4,2,0
428,2019-05-25 11:40:00,138,68.2,123,62.4,261,65.5,2,0
429,2019-05-25 11:45:00,139,68.2,124,62.4,263,65.5,2,0
430,2019-05-25 11:50:00,138,68.2,124,62.4,262,65.5,2,0
431,2019-05-25 11:55:00,137,68.2,123,62.4,260,65.5,2,0
432,2019-05-25 12:00:00,135,68.2,121,62.4,256,65.5,2,0
433,2019-05-25 12:05:00,136,68.1,123,62.3,259,65.3,2,0
434,2019-05-25 12:10:00,136,68.1,122,62.3,258,65.4,2,0
435,2019-05-25 12:15:00,137,68.1,123,62.3,260,65.4,2,0
436,2019-05-25 12:20:00,138,68.1,124,62.3,262,65.4,2,0
437,2019-05-25 12:25:00,137,68.0,123,62.2,260,65.3,2,0
438,2019-05-25 12:30:00,136,68.0,123,62.2,259,65.2,2,0
439,2019-05-25 12:35:00,138,68.0,123,62.2,261,65.3,2,0
440,2019-05-25 12:40:00,139,68.0,124,62.2,263,65.3,2,0
441,2019-05-25 12:45:00,139,68.0,125,62.2,264,65.3,2,0
442,2019-05-25 12:50:00,138,68.1,124,62.3,262,65.4,2,0
443,2019-05-25 12:55:00,136,68.1,123,62.3,259,65.3,2,0
444,2019-05-25 13:00:00,135,68.1,121,62.3,256,65.4,2,0
445,2019-05-25 13:05:00,135,68.1,121,62.3,256,65.4,2,0
446,2019-05-25 13:10:00,136,68.1,122,62.3,258,65.4,2,0
447,2019-05-25 13:15:00,136,68.1,123,62.3,259,65.3,2,0
448,2019-05-25 13:20:00,136,68.1,122,62.3,258,65.4,2,0
449,2019-05-25 13:25:00,135,68.1,122,62.3,257,65.3,2,0
450,2019-05-25 13:30:00,136,68.1,122,62.3,258,65.4,2,0
451,2019-05-25 13:35:00,136,68.2,123,62.4,259,65.4,2,0
452,2019-05-25 13:40:00,138,68.1,123,62.3,261,65.4,2,0
453,2019-05-25 13:45:00,139,68.1,124,62.3,263,65.4,2,0
454,2019-05-25 13:50:00,138,68.1,123,62.3,261,65.4,2,0
455,2019-05-25 13:55:00,136,68.1,122,62.3,258,65.4,2,0
456,2019-05-25 14:00:00,134,68.1,121,62.3,255,65.3,2,0
457,2019-05-25 14:05:00,135,68.1,122,62.3,257,65.3,2,0
458,2019-05-25 14:10:00,137,68.0,123,62.2,260,65.3,2,0
459,2019-05-25 14:15:00,139,68.0,124,62.2,263,65.3,2,0
460,2019-05-25 14:20:00,138,68.0,124,62.2,262,65.3,2,0
461,2019-05-25 14:25:00,138,68.1,124,62.3,262,65.4,2,0
462,2019-05-25 14:30:00,138,68.1,123,62.3,261,65.4,2,0
463,2019-05-25 14:35:00,139,68.0,124,62.2,263,65.3,2,0
464,2019-05-25 14:40:00,139,68.0,124,62.2,263,65.3,2,0
465,2019-05-25 14:45:00,139,68.0,125,62.2,264,65.3,2,0
466,2019-05-25 14:50:00,139,68.1,125,62.3,264,65.4,2,0
467,2019-05-25 14:55:00,137,68.1,123,62.3,260,65.4,2,0
468,2019-05-25 15:00:00,136,68.1,123,62.3,259,65.3,2,0
469,2019-05-25 15:05:00,136,68.1,123,62.3,259,65.3,2,0
470,2019-05-25 15:10:00,137,68.2,123,62.4,260,65.5,2,0
471,2019-05-25 15:15:00,138,68.1,124,62.3,262,65.4,2,0
472,2019-05-25 15:20:00,138,68.1,124,62.3,262,65.4,2,0
473,2019-05-25 15:25:00,139,68.1,124,62.3,263,65.4,2,0
474,2019-05-25 15:30:00,139,68.1,124,62.3,263,65.4,2,0
475,2019-05-25 15:35:00,139,68.1,124,62.3,263,65.4,2,0
476,2019-05-25 15:40:00,140,68.1,126,62.3,266,65.4,2,0
477,2019-05-25 15:45:00,141,68.1,126,62.3,267,65.4,2,0
478,2019-05-25 15:50:00,140,68.1,125,62.3,265,65.4,2,0
479,2019-05-25 15:55:00,138,68.1,123,62.3,261,65.4,2,0
480,2019-05-25 16:00:00,137,68.2,123,62.4,260,65.5,2,0
481,2019-05-25 16:05:00,137,68.3,123,62.5,260,65.6,2,0
482,2019-05-25 16:10:00,138,68.3,124,62.5,262,65.6,2,0
483,2019-05-25 16:15:00,138,68.3,124,62.5,262,65.6,2,0
484,2019-05-25 16:20:00,138,68.4,123,62.6,261,65.7,2,0
485,2019-05-25 16:25:00,139,68.3,124,62.5,263,65.6,2,0
486,2019-05-25 16:30:00,138,68.4,123,62.6,261,65.7,2,0
487,2019-05-25 16:35:00,139,68.5,124,62.7,263,65.8,2,0
488,2019-05-25 16:40:00,138,68.5,124,62.7,262,65.8,2,0
489,2019-05-25 16:45:00,138,68.5,124,62.7,262,65.8,2,0
490,2019-05-25 16:50:00,138,68.5,123,62.7,261,65.8,2,0
491,2019-05-25 16:55:00,136,68.6,122,62.8,258,65.9,2,0
492,2019-05-25 17:00:00,134,68.7,121,62.9,255,66.0,2,0
493,2019-05-25 17:05:00,133,68.9,119,62.9,252,66.1,2,0
494,2019-05-25 17:10:00,135,69.0,122,63.0,257,66.1,2,0
495,2019-05-25 17:15:00,135,69.0,121,63.0,256,66.2,2,0
496,2019-05-25 17:20:00,134,69.0,120,63.0,254,66.2,2,0
497,2019-05-25 17:25:00,133,69.1,120,63.1,253,66.3,2,0
498,2019-05-25 17:30:00,132,69.2,118,63.2,250,66.4,2,0
499,2019-05-25 17:35:00,131,69.2,117,63.2,248,66.4,2,0
500,2019-05-25 17:40:00,131,69.2,117,63.2,248,66.4,2,0
501,2019-05-25 17:45:00,130,69.3,117,63.3,247,66.5,2,0
502,2019-05-25 17:50:00,129,69.3,115,63.3,244,66.5,2,0
503,2019-05-25 17:55:00,126,69.4,113,63.4,239,66.6,2,0
504,2019-05-25 18:00:00,124,69.5,112,63.5,236,66.7,2,0
505,2019-05-25 18:05:00,124,69.6,111,63.6,235,66.8,2,0
506,2019-05-25 18:10:00,124,69.7,112,63.7,236,66.9,2,0
507,2019-05-25 18:15:00,125,69.7,112,63.7,237,66.9,2,0
508,2019-05-25 18:20:00,124,69.8,112,63.8,236,67.0,2,0
509,2019-05-25 18:25:00,123,69.8,110,63.8,233,67.0,2,0
510,2019-05-25 18:30:00,120,69.9,108,63.9,228,67.1,2,0
511,2019-05-25 18:35:00,119,70.0,107,64.0,226,67.2,2,0
512,2019-05-25 18:40:00,117,70.0,106,64.0,223,67.1,2,0
513,2019-05-25 18:45:00,116,70.1,104,64.1,220,67.3,2,0
514,2019-05-25 18:50:00,114,70.1,102,64.1,216,67.3,2,0
515,2019-05-25 18:55:00,112,70.1,100,64.1,212,67.3,2,0
516,2019-05-25 19:00:00,109,70.3,97,64.3,206,67.5,2,0
517,2019-05-25 19:05:00,107,70.4,97,64.4,204,67.5,2,0
518,2019-05-25 19:10:00,108,70.5,97,64.5,205,67.7,2,0
519,2019-05-25 19:15:00,106,70.6,96,64.6,202,67.7,2,0
520,2019-05-25 19:20:00,105,70.6,94,64.6,199,67.8,2,0
521,2019-05-25 19:25:00,103,70.6,93,64.6,196,67.8,2,0
522,2019-05-25 19:30:00,101,70.6,91,64.6,192,67.8,2,0
523,2019-05-25 19:35:00,100,70.6,90,64.6,190,67.8,2,0
524,2019-05-25 19:40:00,100,70.6,89,64.6,189,67.8,2,0
525,2019-05-25 19:45:00,98,70.6,88,64.6,186,67.8,2,0
526,2019-05-25 19:50:00,97,70.5,87,64.5,184,67.7,2,0
527,2019-05-25 19:55:00,96,70.5,86,64.5,182,67.7,2,0
528,2019-05-25 20:00:00,94,70.6,85,64.6,179,67.8,2,0
529,2019-05-25 20:05:00,94,70.6,85,64.6,179,67.8,2,0
530,2019-05-25 20:10:00,94,70.6,85,64.6,179,67.8,2,0
531,2019-05-25 20:15:00,94,70.6,84,64.6,178,67.8,2,0
532,2019-05-25 20:20:00,93,70.5,83,64.5,176,67.7,2,0
533,2019-05-25 20:25:00,93,70.5,84,64.5,177,67.7,2,0
534,2019-05-25 20:30:00,91,70.4,82,64.4,173,67.6,2,0
535,2019-05-25 20:35:00,90,70.4,81,64.4,171,67.6,2,0
536,2019-05-25 20:40:00,90,70.3,80,64.3,170,67.5,2,0
537,2019-05-25 20:45:00,89,70.2,80,64.2,169,67.4,2,0
538,2019-05-25 20:50:00,88,70.0,79,64.0,167,67.2,2,0
539,2019-05-25 20:55:00,87,69.9,78,63.9,165,67.1,2,0
540,2019-05-25 21:00:00,86,70.2,78,64.2,164,67.3,2,0
541,2019-05-25 21:05:00,87,70.4,78,64.4,165,67.6,2,0
542,2019-05-25 21:10:00,87,70.4,79,64.4,166,67.5,2,0
543,2019-05-25 21:15:00,88,70.4,79,64.4,167,67.6,2,0
544,2019-05-25 21:20:00,88,70.5,79,64.5,167,67.7,2,0
545,2019-05-25 21:25:00,87,70.5,78,64.5,165,67.7,2,0
546,2019-05-25 21:30:00,87,70.5,78,64.5,165,67.7,2,0
547,2019-05-25 21:35:00,86,70.6,77,64.6,163,67.8,2,0
548,2019-05-25 21:40:00,85,70.6,77,64.6,162,67.7,2,0
549,2019-05-25 21:45:00,85,70.7,77,64.7,162,67.8,2,0
550,2019-05-25 21:50:00,84,70.7,76,64.7,160,67.9,2,0
551,2019-05-25 21:55:00,83,70.8,74,64.8,157,68.0,2,0
552,2019-05-25 22:00:00,82,70.8,74,64.8,156,68.0,2,0
553,2019-05-25 22:05:00,82,70.8,73,64.8,155,68.0,2,0
554,2019-05-25 22:10:00,83,70.8,74,64.8,157,68.0,2,0
555,2019-05-25 22:15:00,81,70.8,73,64.8,154,68.0,2,0
556,2019-05-25 22:20:00,81,70.8,72,64.8,153,68.0,2,0
557,2019-05-25 22:25:00,79,70.9,70,64.9,149,68.1,2,0
558,2019-05-25 22:30:00,76,70.9,69,64.9,145,68.0,2,0
559,2019-05-25 22:35:00,74,71.0,67,65.0,141,68.2,2,0
560,2019-05-25 22:40:00,73,71.0,66,65.0,139,68.2,2,0
561,2019-05-25 22:45:00,72,71.2,64,65.0,136,68.3,2,0
562,2019-05-25 22:50:00,70,71.2,62,65.0,132,68.3,2,0
563,2019-05-25 22:55:00,66,71.3,60,65.1,126,68.3,2,0
564,2019-05-25 23:00:00,65,71.0,58,65.0,123,68.2,2,0
565,2019-05-25 23:05:00,64,70.9,57,64.9,121,68.1,2,0
566,2019-05-25 23:10:00,63,70.9,56,64.9,119,68.1,2,0
567,2019-05-25 23:15:00,61,70.9,55,64.9,116,68.1,2,0
568,2019-05-25 23:20:00,58,70.9,53,64.9,111,68.0,2,0
569,2019-05-25 23:25:00,57,70.9,51,64.9,108,68.1,2,0
570,2019-05-25 23:30:00,55,70.9,49,64.9,104,68.1,2,0
571,2019-05-25 23:35:00,54,71.0,48,65.0,102,68.2,2,0
572,2019-05-25 23:40:00,52,71.0,47,65.0,99,68.2,2,0
573,2019-05-25 23:45:00,51,71.0,45,65.0,96,68.2,2,0
574,2019-05-25 23:50:00,48,71.0,44,65.0,92,68.1,2,0
575,2019-05-25 23:55:00,45,71.0,41,65.0,86,68.1,2,0
576,2019-05-26 00:00:00,44,71.3,39,65.1,83,68.4,2,0
577,2019-05-26 00:05:00,42,71.0,38,65.0,80,68.2,2,0
578,2019-05-26 00:10:00,41,71.0,37,65.0,78,68.2,2,0
579,2019-05-26 00:15:00,38,70.9,35,64.9,73,68.0,2,0
580,2019-05-26 00:20:00,37,70.9,34,64.9,71,68.0,2,0
581,2019-05-26 00:25:00,35,70.9,31,64.9,66,68.1,2,0
582,2019-05-26 00:30:00,34,70.9,30,64.9,64,68.1,2,0
583,2019-05-26 00:35:00,31,70.9,28,64.9,59,68.1,2,0
584,2019-05-26 00:40:00,27,70.9,25,64.9,52,68.0,2,0
585,2019-05-26 00:45:00,26,70.9,24,64.9,50,68.0,2,0
586,2019-05-26 00:50:00,25,70.9,22,64.9,47,68.1,2,0
587,2019-05-26 00:55:00,25,70.9,22,64.9,47,68.1,2,0
588,2019-05-26 01:00:00,24,70.8,22,64.8,46,67.9,2,0
589,2019-05-26 01:05:00,23,70.8,21,64.8,44,67.9,2,0
590,2019-05-26 01:10:00,22,70.8,19,64.8,41,68.0,2,0
591,2019-05-26 01:15:00,21,70.8,18,64.8,39,68.0,2,0
592,2019-05-26 01:20:00,19,70.8,18,64.8,37,67.9,2,0
593,2019-05-26 01:25:00,19,70.9,17,64.9,36,68.1,2,0
594,2019-05-26 01:30:00,18,70.8,16,64.8,34,68.0,2,0
595,2019-05-26 01:35:00,17,70.8,16,64.8,33,67.9,2,0
596,2019-05-26 01:40:00,17,70.8,15,64.8,32,68.0,2,0
597,2019-05-26 01:45:00,16,70.8,15,64.8,31,67.9,2,0
598,2019-05-26 01:50:00,16,70.8,15,64.8,31,67.9,2,0
599,2019-05-26 01:55:00,16,70.8,14,64.8,30,68.0,2,0
600,2019-05-26 02:00:00,15,70.8,14,64.8,29,67.9,2,0
601,2019-05-26 02:05:00,15,70.8,13,64.8,28,68.0,2,0
602,2019-05-26 02:10:00,14,70.8,13,64.8,27,67.9,2,0
603,2019-05-26 02:15:00,14,70.8,12,64.8,26,68.0,2,0
604,2019-05-26 02:20:00,13,70.8,12,64.8,25,67.9,2,0
605,2019-05-26 02:25:00,13,70.8,11,64.8,24,68.1,2,0
606,2019-05-26 02:30:00,13,70.9,11,64.9,24,68.2,2,0
607,2019-05-26 02:35:00,12,70.8,11,64.8,23,67.9,2,0
608,2019-05-26 02:40:00,12,70.8,10,64.8,22,68.1,2,0
609,2019-05-26 02:45:00,11,70.8,10,64.8,21,67.9,2,0
610,2019-05-26 02:50:00,11,70.8,9,64.8,20,68.1,2,0
611,2019-05-26 02:55:00,10,70.8,9,64.8,19,68.0,2,0
612,2019-05-26 03:00:00,10,70.8,9,64.8,19,68.0,2,0
613,2019-05-26 03:05:00,9,70.8,9,64.8,18,67.8,2,0
614,2019-05-26 03:10:00,9,70.8,8,64.8,17,68.0,2,0
615,2019-05-26 03:15:00,9,70.8,8,64.8,17,68.0,2,0
616,2019-05-26 03:20:00,8,70.8,8,64.8,16,67.8,2,0
617,2019-05-26 03:25:00,8,70.8,8,64.8,16,67.8,2,0
618,2019-05-26 03:30:00,8,70.8,8,64.8,16,67.8,2,0
619,2019-05-26 03:35:00,8,70.8,8,64.8,16,67.8,2,0
620,2019-05-26 03:40:00,8,70.8,8,64.8,16,67.8,2,0
621,2019-05-26 03:45:00,8,70.8,8,64.8,16,67.8,2,0
622,2019-05-26 03:50:00,8,70.8,7,64.8,15,68.0,2,0
623,2019-05-26 03:55:00,8,70.8,7,64.8,15,68.0,2,0
624,2019-05-26 04:00:00,7,70.8,7,64.8,14,67.8,2,0
625,2019-05-26 04:05:00,7,70.8,7,64.8,14,67.8,2,0
626,2019-05-26 04:10:00,8,70.8,7,64.8,15,68.0,2,0
627,2019-05-26 04:15:00,8,70.8,7,64.8,15,68.0,2,0
628,2019-05-26 04:20:00,8,70.8,8,64.8,16,67.8,2,0
629,2019-05-26 04:25:00,8,70.8,8,64.8,16,67.8,2,0
630,2019-05-26 04:30:00,8,70.8,8,64.8,16,67.8,2,0
631,2019-05-26 04:35:00,9,70.8,8,64.8,17,68.0,2,0
632,2019-05-26 04:40:00,10,70.8,9,64.8,19,68.0,2,0
633,2019-05-26 04:45:00,11,70.8,9,64.8,20,68.1,2,0
634,2019-05-26 04:50:00,11,70.8,9,64.8,20,68.1,2,0
635,2019-05-26 04:55:00,11,70.8,9,64.8,20,68.1,2,0
636,2019-05-26 05:00:00,10,70.7,9,64.7,19,67.9,2,0
637,2019-05-26 05:05:00,11,70.8,9,64.8,20,68.1,2,0
638,2019-05-26 05:10:00,12,70.8,10,64.8,22,68.1,2,0
639,2019-05-26 05:15:00,13,70.8,11,64.8,24,68.1,2,0
640,2019-05-26 05:20:00,13,70.8,12,64.8,25,67.9,2,0
641,2019-05-26 05:25:00,14,70.8,12,64.8,26,68.0,2,0
642,2019-05-26 05:30:00,15,70.8,13,64.8,28,68.0,2,0
643,2019-05-26 05:35:00,16,70.8,14,64.8,30,68.0,2,0
644,2019-05-26 05:40:00,17,70.8,15,64.8,32,68.0,2,0
645,2019-05-26 05:45:00,18,70.8,16,64.8,34,68.0,2,0
646,2019-05-26 05:50:00,18,70.8,17,64.8,35,67.9,2,0
647,2019-05-26 05:55:00,18,70.8,16,64.8,34,68.0,2,0
648,2019-05-26 06:00:00,18,70.8,16,64.8,34,68.0,2,0
649,2019-05-26 06:05:00,19,70.8,17,64.8,36,68.0,2,0
650,2019-05-26 06:10:00,21,70.8,19,64.8,40,68.0,2,0
651,2019-05-26 06:15:00,23,70.8,21,64.8,44,67.9,2,0
652,2019-05-26 06:20:00,25,70.8,22,64.8,47,68.0,2,0
653,2019-05-26 06:25:00,26,70.8,24,64.8,50,67.9,2,0
654,2019-05-26 06:30:00,27,70.9,25,64.9,52,68.0,2,0
655,2019-05-26 06:35:00,30,70.9,26,64.9,56,68.1,2,0
656,2019-05-26 06:40:00,32,70.9,28,64.9,60,68.1,2,0
657,2019-05-26 06:45:00,33,70.9,30,64.9,63,68.0,2,0
658,2019-05-26 06:50:00,34,70.9,30,64.9,64,68.1,2,0
659,2019-05-26 06:55:00,32,70.9,29,64.9,61,68.0,2,0
660,2019-05-26 07:00:00,32,70.8,29,64.8,61,67.9,2,0
661,2019-05-26 07:05:00,33,70.8,29,64.8,62,68.0,2,0
662,2019-05-26 07:10:00,35,70.8,32,64.8,67,67.9,2,0
663,2019-05-26 07:15:00,38,70.8,34,64.8,72,68.0,2,0
664,2019-05-26 07:20:00,40,70.8,35,64.8,75,68.0,2,0
665,2019-05-26 07:25:00,41,70.8,37,64.8,78,68.0,2,0
666,2019-05-26 07:30:00,43,70.8,39,64.8,82,67.9,2,0
667,2019-05-26 07:35:00,47,70.8,42,64.8,89,68.0,2,0
668,2019-05-26 07:40:00,50,70.8,45,64.8,95,68.0,2,0
669,2019-05-26 07:45:00,53,70.9,47,64.9,100,68.1,2,0
670,2019-05-26 07:50:00,54,70.9,48,64.9,102,68.1,2,0
671,2019-05-26 07:55:00,53,70.8,48,64.8,101,68.0,2,0
672,2019-05-26 08:00:00,53,70.8,47,64.8,100,68.0,2,0
673,2019-05-26 08:05:00,53,70.8,48,64.8,101,68.0,2,0
674,2019-05-26 08:10:00,56,70.8,51,64.8,107,67.9,2,0
675,2019-05-26 08:15:00,59,70.8,53,64.8,112,68.0,2,0
676,2019-05-26 08:20:00,62,70.8,55,64.8,117,68.0,2,0
677,2019-05-26 08:25:00,64,70.8,57,64.8,121,68.0,2,0
678,2019-05-26 08:30:00,65,70.9,58,64.9,123,68.1,2,0
679,2019-05-26 08:35:00,68,70.8,61,64.8,129,68.0,2,0
680,2019-05-26 08:40:00,73,70.8,65,64.8,138,68.0,2,0
681,2019-05-26 08:45:00,76,70.8,68,64.8,144,68.0,2,0
682,2019-05-26 08:50:00,77,70.7,70,64.7,147,67.8,2,0
683,2019-05-26 08:55:00,77,70.7,70,64.7,147,67.8,2,0
684,2019-05-26 09:00:00,76,70.6,69,64.6,145,67.7,2,0
685,2019-05-26 09:05:00,78,70.6,70,64.6,148,67.8,2,0
686,2019-05-26 09:10:00,81,70.6,73,64.6,154,67.8,2,0
687,2019-05-26 09:15:00,85,70.6,77,64.6,162,67.7,2,0
688,2019-05-26 09:20:00,89,70.5,79,64.5,168,67.7,2,0
689,2019-05-26 09:25:00,91,70.5,82,64.5,173,67.7,2,0
690,2019-05-26 09:30:00,94,70.5,85,64.5,179,67.7,2,0
691,2019-05-26 09:35:00,97,70.4,87,64.4,184,67.6,2,0
692,2019-05-26 09:40:00,102,70.4,91,64.4,193,67.6,2,0
693,2019-05-26 09:45:00,105,70.3,95,64.3,200,67.5,2,0
694,2019-05-26 09:50:00,106,70.3,96,64.3,202,67.4,2,0
695,2019-05-26 09:55:00,106,70.3,96,64.3,202,67.4,2,0
696,2019-05-26 10:00:00,104,70.1,93,64.1,197,67.3,2,0
697,2019-05-26 10:05:00,104,69.9,94,63.9,198,67.1,2,0
698,2019-05-26 10:10:00,107,69.9,97,63.9,204,67.0,2,0
699,2019-05-26 10:15:00,111,69.8,100,63.8,211,67.0,2,0
700,2019-05-26 10:20:00,113,69.7,102,63.7,215,66.9,2,0
701,2019-05-26 10:25:00,114,69.6,102,63.6,216,66.8,2,0
702,2019-05-26 10:30:00,116,69.6,104,63.6,220,66.8,2,0
703,2019-05-26 10:35:00,119,69.5,106,63.5,225,66.7,2,0
704,2019-05-26 10:40:00,122,69.4,110,63.4,232,66.6,2,0
705,2019-05-26 10:45:00,124,69.3,111,63.3,235,66.5,2,0
706,2019-05-26 10:50:00,125,69.2,112,63.2,237,66.4,2,0
707,2019-05-26 10:55:00,124,69.2,112,63.2,236,66.4,2,0
708,2019-05-26 11:00:00,123,69.2,110,63.2,233,66.4,2,0
709,2019-05-26 11:05:00,122,69.2,109,63.2,231,66.4,2,0
710,2019-05-26 11:10:00,124,69.1,112,63.1,236,66.3,2,0
711,2019-05-26 11:15:00,124,69.0,112,63.0,236,66.2,2,0
712,2019-05-26 11:20:00,124,69.0,112,63.0,236,66.2,2,0
713,2019-05-26 11:25:00,124,69.0,112,63.0,236,66.2,2,0
714,2019-05-26 11:30:00,125,69.0,113,63.0,238,66.1,2,0
715,2019-05-26 11:35:00,125,69.0,112,63.0,237,66.2,2,0
716,2019-05-26 11:40:00,128,69.0,114,63.0,242,66.2,2,0
717,2019-05-26 11:45:00,130,68.9,116,62.9,246,66.1,2,0
718,2019-05-26 11:50:00,129,68.9,115,62.9,244,66.1,2,0
719,2019-05-26 11:55:00,128,68.9,114,62.9,242,66.1,2,0
720,2019-05-26 12:00:00,127,68.6,114,62.8,241,65.9,2,0
721,2019-05-26 12:05:00,127,68.5,114,62.7,241,65.8,2,0
722,2019-05-26 12:10:00,128,68.4,115,62.6,243,65.7,2,0
723,2019-05-26 12:15:00,129,68.4,115,62.6,244,65.7,2,0
724,2019-05-26 12:20:00,130,68.3,116,62.5,246,65.6,2,0
725,2019-05-26 12:25:00,129,68.4,116,62.6,245,65.7,2,0
726,2019-05-26 12:30:00,130,68.3,116,62.5,246,65.6,2,0
727,2019-05-26 12:35:00,130,68.2,117,62.4,247,65.5,2,0
728,2019-05-26 12:40:00,130,68.2,117,62.4,247,65.5,2,0
729,2019-05-26 12:45:00,131,68.2,117,62.4,248,65.5,2,0
730,2019-05-26 12:50:00,131,68.1,117,62.3,248,65.4,2,0
731,2019-05-26 12:55:00,130,68.2,116,62.4,246,65.5,2,0
732,2019-05-26 13:00:00,129,68.1,115,62.3,244,65.4,2,0
733,2019-05-26 13:05:00,128,68.1,114,62.3,242,65.4,2,0
734,2019-05-26 13:10:00,129,68.0,116,62.2,245,65.3,2,0
735,2019-05-26 13:15:00,130,68.1,116,62.3,246,65.4,2,0
736,2019-05-26 13:20:00,130,68.1,117,62.3,247,65.4,2,0
737,2019-05-26 13:25:00,129,68.0,116,62.2,245,65.3,2,0
738,2019-05-26 13:30:00,130,68.0,116,62.2,246,65.3,2,0
739,2019-05-26 13:35:00,129,68.0,116,62.2,245,65.3,2,0
740,2019-05-26 13:40:00,130,68.0,117,62.2,247,65.3,2,0
741,2019-05-26 13:45:00,130,68.0,116,62.2,246,65.3,2,0
742,2019-05-26 13:50:00,130,68.1,117,62.3,247,65.4,2,0
743,2019-05-26 13:55:00,129,68.1,116,62.3,245,65.4,2,0
744,2019-05-26 14:00:00,128,68.1,114,62.3,242,65.4,2,0
745,2019-05-26 14:10:00,129,68.1,116,62.3,245,65.4,2,0
746,2019-05-26 14:15:00,130,68.1,116,62.3,246,65.4,2,0
747,2019-05-26 14:20:00,130,68.1,117,62.3,247,65.4,2,0
748,2019-05-26 14:25:00,131,68.2,117,62.4,248,65.5,2,0
749,2019-05-26 14:30:00,130,68.1,116,62.3,246,65.4,2,0
750,2019-05-26 14:35:00,130,68.2,116,62.4,246,65.5,2,0
751,2019-05-26 14:40:00,129,68.2,116,62.4,245,65.5,2,0
752,2019-05-26 14:45:00,130,68.2,117,62.4,247,65.5,2,0
753,2019-05-26 14:50:00,129,68.3,115,62.5,244,65.6,2,0
754,2019-05-26 14:55:00,128,68.3,114,62.5,242,65.6,2,0
755,2019-05-26 15:00:00,126,68.3,113,62.5,239,65.6,2,0
756,2019-05-26 15:05:00,126,68.3,113,62.5,239,65.6,2,0
757,2019-05-26 15:10:00,126,68.4,113,62.6,239,65.7,2,0
758,2019-05-26 15:15:00,128,68.4,114,62.6,242,65.7,2,0
759,2019-05-26 15:20:00,128,68.4,114,62.6,242,65.7,2,0
760,2019-05-26 15:25:00,129,68.4,115,62.6,244,65.7,2,0
761,2019-05-26 15:30:00,128,68.4,114,62.6,242,65.7,2,0
762,2019-05-26 15:35:00,129,68.5,115,62.7,244,65.8,2,0
763,2019-05-26 15:40:00,129,68.5,116,62.7,245,65.8,2,0
764,2019-05-26 15:45:00,129,68.5,115,62.7,244,65.8,2,0
765,2019-05-26 15:50:00,128,68.5,115,62.7,243,65.8,2,0
766,2019-05-26 15:55:00,127,68.5,114,62.7,241,65.8,2,0
767,2019-05-26 16:00:00,125,68.6,113,62.8,238,65.8,2,0
768,2019-05-26 16:05:00,125,68.6,113,62.8,238,65.8,2,0
769,2019-05-26 16:10:00,125,68.7,113,62.9,238,65.9,2,0
770,2019-05-26 16:15:00,126,68.7,113,62.9,239,66.0,2,0
771,2019-05-26 16:20:00,127,68.7,114,62.9,241,66.0,2,0
772,2019-05-26 16:25:00,127,68.7,114,62.9,241,66.0,2,0
773,2019-05-26 16:30:00,126,68.7,113,62.9,239,66.0,2,0
774,2019-05-26 16:35:00,125,68.7,113,62.9,238,65.9,2,0
775,2019-05-26 16:40:00,126,68.7,113,62.9,239,66.0,2,0
776,2019-05-26 16:45:00,126,68.7,113,62.9,239,66.0,2,0
777,2019-05-26 16:50:00,124,68.9,112,62.9,236,66.1,2,0
778,2019-05-26 16:55:00,123,68.9,111,62.9,234,66.1,2,0
779,2019-05-26 17:00:00,122,69.0,110,63.0,232,66.2,2,0
780,2019-05-26 17:05:00,122,69.1,110,63.1,232,66.3,2,0
781,2019-05-26 17:10:00,124,69.1,111,63.1,235,66.3,2,0
782,2019-05-26 17:15:00,124,69.1,112,63.1,236,66.3,2,0
783,2019-05-26 17:20:00,124,69.1,111,63.1,235,66.3,2,0
784,2019-05-26 17:25:00,122,69.2,110,63.2,232,66.4,2,0
785,2019-05-26 17:30:00,121,69.2,108,63.2,229,66.4,2,0
786,2019-05-26 17:35:00,120,69.3,108,63.3,228,66.5,2,0
787,2019-05-26 17:40:00,120,69.3,107,63.3,227,66.5,2,0
788,2019-05-26 17:45:00,119,69.3,106,63.3,225,66.5,2,0
789,2019-05-26 17:50:00,118,69.4,106,63.4,224,66.6,2,0
790,2019-05-26 17:55:00,116,69.4,105,63.4,221,66.5,2,0
791,2019-05-26 18:00:00,114,69.5,103,63.5,217,66.7,2,0
792,2019-05-26 18:05:00,114,69.6,102,63.6,216,66.8,2,0
793,2019-05-26 18:10:00,116,69.7,104,63.7,220,66.9,2,0
794,2019-05-26 18:15:00,114,69.7,103,63.7,217,66.9,2,0
795,2019-05-26 18:20:00,115,69.8,103,63.8,218,67.0,2,0
796,2019-05-26 18:25:00,114,69.8,103,63.8,217,67.0,2,0
797,2019-05-26 18:30:00,113,69.8,101,63.8,214,67.0,2,0
798,2019-05-26 18:35:00,112,69.9,100,63.9,212,67.1,2,0
799,2019-05-26 18:40:00,110,69.9,99,63.9,209,67.1,2,0
800,2019-05-26 18:45:00,109,69.9,97,63.9,206,67.1,2,0
801,2019-05-26 18:50:00,107,69.9,96,63.9,203,67.1,2,0
802,2019-05-26 18:55:00,106,69.9,96,63.9,202,67.0,2,0
803,2019-05-26 19:00:00,104,70.2,93,64.2,197,67.4,2,0
804,2019-05-26 19:05:00,103,70.3,92,64.3,195,67.5,2,0
805,2019-05-26 19:10:00,104,70.3,93,64.3,197,67.5,2,0
806,2019-05-26 19:15:00,104,70.4,93,64.4,197,67.6,2,0
807,2019-05-26 19:20:00,102,70.4,91,64.4,193,67.6,2,0
808,2019-05-26 19:25:00,100,70.3,90,64.3,190,67.5,2,0
809,2019-05-26 19:30:00,99,70.3,89,64.3,188,67.5,2,0
810,2019-05-26 19:35:00,99,70.3,89,64.3,188,67.5,2,0
811,2019-05-26 19:40:00,98,70.3,88,64.3,186,67.5,2,0
812,2019-05-26 19:45:00,97,70.2,88,64.2,185,67.3,2,0
813,2019-05-26 19:50:00,96,70.1,87,64.1,183,67.2,2,0
814,2019-05-26 19:55:00,96,70.1,87,64.1,183,67.2,2,0
815,2019-05-26 20:00:00,95,70.3,86,64.3,181,67.4,2,0
816,2019-05-26 20:05:00,94,70.3,85,64.3,179,67.5,2,0
817,2019-05-26 20:10:00,95,70.4,85,64.4,180,67.6,2,0
818,2019-05-26 20:15:00,95,70.3,86,64.3,181,67.4,2,0
819,2019-05-26 20:20:00,94,70.3,84,64.3,178,67.5,2,0
820,2019-05-26 20:25:00,93,70.2,83,64.2,176,67.4,2,0
821,2019-05-26 20:30:00,91,70.2,82,64.2,173,67.4,2,0
822,2019-05-26 20:35:00,91,70.1,81,64.1,172,67.3,2,0
823,2019-05-26 20:40:00,89,70.1,79,64.1,168,67.3,2,0
824,2019-05-26 20:45:00,88,70.0,79,64.0,167,67.2,2,0
825,2019-05-26 20:50:00,86,69.9,77,63.9,163,67.1,2,0
826,2019-05-26 20:55:00,84,69.8,76,63.8,160,66.9,2,0
827,2019-05-26 21:00:00,83,70.1,75,64.1,158,67.3,2,0
828,2019-05-26 21:05:00,83,70.2,74,64.2,157,67.4,2,0
829,2019-05-26 21:10:00,83,70.3,74,64.3,157,67.5,2,0
830,2019-05-26 21:15:00,82,70.4,73,64.4,155,67.6,2,0
831,2019-05-26 21:20:00,80,70.4,72,64.4,152,67.6,2,0
832,2019-05-26 21:25:00,79,70.4,70,64.4,149,67.6,2,0
833,2019-05-26 21:30:00,77,70.5,69,64.5,146,67.7,2,0
834,2019-05-26 21:35:00,76,70.6,68,64.6,144,67.8,2,0
835,2019-05-26 21:40:00,74,70.6,67,64.6,141,67.8,2,0
836,2019-05-26 21:45:00,73,70.6,65,64.6,138,67.8,2,0
837,2019-05-26 21:50:00,70,70.7,63,64.7,133,67.9,2,0
838,2019-05-26 21:55:00,69,70.8,62,64.8,131,68.0,2,0
839,2019-05-26 22:00:00,66,70.8,60,64.8,126,67.9,2,0
840,2019-05-26 22:05:00,66,70.8,59,64.8,125,68.0,2,0
841,2019-05-26 22:10:00,64,70.8,58,64.8,122,67.9,2,0
842,2019-05-26 22:15:00,63,70.8,57,64.8,120,68.0,2,0
843,2019-05-26 22:20:00,61,70.8,54,64.8,115,68.0,2,0
844,2019-05-26 22:25:00,58,70.9,52,64.9,110,68.1,2,0
845,2019-05-26 22:30:00,57,70.9,51,64.9,108,68.1,2,0
846,2019-05-26 22:35:00,54,71.0,49,65.0,103,68.1,2,0
847,2019-05-26 22:40:00,53,71.0,47,65.0,100,68.2,2,0
848,2019-05-26 22:45:00,50,71.0,45,65.0,95,68.2,2,0
849,2019-05-26 22:50:00,48,71.0,44,65.0,92,68.1,2,0
850,2019-05-26 22:55:00,45,71.0,41,65.0,86,68.1,2,0
851,2019-05-26 23:00:00,43,70.9,39,64.9,82,68.0,2,0
852,2019-05-26 23:05:00,42,70.9,38,64.9,80,68.1,2,0
853,2019-05-26 23:10:00,41,70.9,37,64.9,78,68.1,2,0
854,2019-05-26 23:15:00,40,70.9,36,64.9,76,68.1,2,0
855,2019-05-26 23:20:00,38,70.9,34,64.9,72,68.1,2,0
856,2019-05-26 23:25:00,36,70.9,32,64.9,68,68.1,2,0
857,2019-05-26 23:30:00,34,70.8,30,64.8,64,68.0,2,0
858,2019-05-26 23:35:00,33,70.9,30,64.9,63,68.0,2,0
859,2019-05-26 23:40:00,32,70.9,28,64.9,60,68.1,2,0
860,2019-05-26 23:45:00,30,70.9,27,64.9,57,68.1,2,0
861,2019-05-26 23:50:00,28,70.8,26,64.8,54,67.9,2,0
862,2019-05-26 23:55:00,26,70.8,24,64.8,50,67.9,2,0
863,2019-05-27 00:00:00,25,71.3,22,65.1,47,68.4,2,0
864,2019-05-27 00:05:00,24,71.2,22,65.0,46,68.2,2,0
865,2019-05-27 00:10:00,23,71.0,21,65.0,44,68.1,2,0
866,2019-05-27 00:15:00,22,70.9,19,64.9,41,68.1,2,0
867,2019-05-27 00:20:00,21,70.9,18,64.9,39,68.1,2,0
868,2019-05-27 00:25:00,18,70.8,17,64.8,35,67.9,2,0
869,2019-05-27 00:30:00,17,70.8,16,64.8,33,67.9,2,0
870,2019-05-27 00:35:00,16,70.9,15,64.9,31,68.0,2,0
871,2019-05-27 00:40:00,16,70.8,14,64.8,30,68.0,2,0
872,2019-05-27 00:45:00,15,70.8,13,64.8,28,68.0,2,0
873,2019-05-27 00:50:00,14,70.8,13,64.8,27,67.9,2,0
874,2019-05-27 00:55:00,13,70.8,12,64.8,25,67.9,2,0
875,2019-05-27 01:00:00,12,70.8,11,64.8,23,67.9,2,0
876,2019-05-27 01:05:00,12,70.9,10,64.9,22,68.2,2,0
877,2019-05-27 01:10:00,11,70.8,10,64.8,21,67.9,2,0
878,2019-05-27 01:15:00,11,70.8,9,64.8,20,68.1,2,0
879,2019-05-27 01:20:00,11,70.8,9,64.8,20,68.1,2,0
880,2019-05-27 01:25:00,10,70.8,9,64.8,19,68.0,2,0
881,2019-05-27 01:30:00,9,70.7,9,64.7,18,67.7,2,0
882,2019-05-27 01:35:00,9,70.7,9,64.7,18,67.7,2,0
883,2019-05-27 01:40:00,9,70.7,8,64.7,17,67.9,2,0
884,2019-05-27 01:45:00,9,70.7,8,64.7,17,67.9,2,0
885,2019-05-27 01:50:00,9,70.7,8,64.7,17,67.9,2,0
886,2019-05-27 01:55:00,8,70.6,8,64.6,16,67.6,2,0
887,2019-05-27 02:00:00,8,70.7,7,64.7,15,67.9,2,0
888,2019-05-27 02:05:00,8,70.7,7,64.7,15,67.9,2,0
889,2019-05-27 02:10:00,8,70.7,7,64.7,15,67.9,2,0
890,2019-05-27 02:15:00,8,70.7,7,64.7,15,67.9,2,0
891,2019-05-27 02:20:00,8,70.7,7,64.7,15,67.9,2,0
892,2019-05-27 02:25:00,7,70.7,7,64.7,14,67.7,2,0
893,2019-05-27 02:30:00,7,70.6,7,64.6,14,67.6,2,0
894,2019-05-27 02:35:00,8,70.6,7,64.6,15,67.8,2,0
895,2019-05-27 02:40:00,8,70.6,7,64.6,15,67.8,2,0
896,2019-05-27 02:45:00,7,70.6,7,64.6,14,67.6,2,0
897,2019-05-27 02:50:00,7,70.5,7,64.5,14,67.5,2,0
898,2019-05-27 02:55:00,7,70.5,7,64.5,14,67.5,2,0
899,2019-05-27 03:00:00,7,70.5,7,64.5,14,67.5,2,0
900,2019-05-27 03:05:00,7,70.5,7,64.5,14,67.5,2,0
901,2019-05-27 03:10:00,7,70.5,7,64.5,14,67.5,2,0
902,2019-05-27 03:15:00,8,70.5,7,64.5,15,67.7,2,0
903,2019-05-27 03:20:00,8,70.5,8,64.5,16,67.5,2,0
904,2019-05-27 03:25:00,9,70.5,8,64.5,17,67.7,2,0
905,2019-05-27 03:30:00,9,70.5,9,64.5,18,67.5,2,0
906,2019-05-27 03:35:00,10,70.5,9,64.5,19,67.7,2,0
907,2019-05-27 03:40:00,11,70.5,10,64.5,21,67.6,2,0
908,2019-05-27 03:45:00,12,70.5,10,64.5,22,67.8,2,0
909,2019-05-27 03:50:00,12,70.5,11,64.5,23,67.6,2,0
910,2019-05-27 03:55:00,12,70.5,11,64.5,23,67.6,2,0
911,2019-05-27 04:00:00,12,70.4,11,64.4,23,67.5,2,0
912,2019-05-27 04:05:00,13,70.4,11,64.4,24,67.7,2,0
913,2019-05-27 04:10:00,14,70.4,12,64.4,26,67.6,2,0
914,2019-05-27 04:15:00,15,70.5,14,64.5,29,67.6,2,0
915,2019-05-27 04:20:00,16,70.5,15,64.5,31,67.6,2,0
916,2019-05-27 04:25:00,18,70.6,16,64.6,34,67.8,2,0
917,2019-05-27 04:30:00,19,70.6,18,64.6,37,67.7,2,0
918,2019-05-27 04:35:00,22,70.7,20,64.7,42,67.8,2,0
919,2019-05-27 04:40:00,25,70.7,22,64.7,47,67.9,2,0
920,2019-05-27 04:45:00,27,70.8,24,64.8,51,68.0,2,0
921,2019-05-27 04:50:00,29,70.8,26,64.8,55,68.0,2,0
922,2019-05-27 04:55:00,29,70.8,26,64.8,55,68.0,2,0
923,2019-05-27 05:00:00,30,70.7,26,64.7,56,67.9,2,0
924,2019-05-27 05:05:00,32,70.6,28,64.6,60,67.8,2,0
925,2019-05-27 05:10:00,36,70.6,32,64.6,68,67.8,2,0
926,2019-05-27 05:15:00,38,70.5,35,64.5,73,67.6,2,0
927,2019-05-27 05:20:00,43,70.5,38,64.5,81,67.7,2,0
928,2019-05-27 05:25:00,46,70.5,41,64.5,87,67.7,2,0
929,2019-05-27 05:30:00,49,70.5,44,64.5,93,67.7,2,0
930,2019-05-27 05:35:00,53,70.4,48,64.4,101,67.5,2,0
931,2019-05-27 05:40:00,58,70.5,52,64.5,110,67.7,2,0
932,2019-05-27 05:45:00,60,70.6,54,64.6,114,67.8,2,0
933,2019-05-27 05:50:00,61,70.7,54,64.7,115,67.9,2,0
934,2019-05-27 05:55:00,61,70.6,54,64.6,115,67.8,2,0
935,2019-05-27 06:00:00,60,70.1,54,64.1,114,67.3,2,0
936,2019-05-27 06:05:00,63,69.7,57,63.7,120,66.8,2,0
937,2019-05-27 06:10:00,68,69.6,61,63.6,129,66.8,2,0
938,2019-05-27 06:15:00,73,69.5,65,63.5,138,66.7,2,0
939,2019-05-27 06:20:00,77,69.5,70,63.5,147,66.6,2,0
940,2019-05-27 06:25:00,81,69.4,73,63.4,154,66.6,2,0
941,2019-05-27 06:30:00,85,69.4,76,63.4,161,66.6,2,0
942,2019-05-27 06:35:00,89,69.4,80,63.4,169,66.6,2,0
943,2019-05-27 06:40:00,94,69.5,85,63.5,179,66.6,2,0
944,2019-05-27 06:45:00,98,69.5,88,63.5,186,66.7,2,0
945,2019-05-27 06:50:00,98,69.6,88,63.6,186,66.8,2,0
946,2019-05-27 06:55:00,96,69.6,86,63.6,182,66.8,2,0
947,2019-05-27 07:00:00,95,69.0,85,63.0,180,66.2,2,0
948,2019-05-27 07:05:00,98,68.5,88,62.7,186,65.8,2,0
949,2019-05-27 07:10:00,104,68.4,93,62.6,197,65.7,2,0
950,2019-05-27 07:15:00,109,68.2,97,62.4,206,65.5,2,0
951,2019-05-27 07:20:00,113,68.2,102,62.4,215,65.4,2,0
952,2019-05-27 07:25:00,115,68.1,104,62.3,219,65.3,2,0
953,2019-05-27 07:30:00,117,68.1,105,62.3,222,65.4,2,0
954,2019-05-27 07:35:00,121,68.0,109,62.2,230,65.3,2,0
955,2019-05-27 07:40:00,124,68.0,112,62.2,236,65.2,2,0
956,2019-05-27 07:45:00,126,68.0,114,62.2,240,65.2,2,0
957,2019-05-27 07:50:00,125,68.0,113,62.2,238,65.2,2,0
958,2019-05-27 07:55:00,123,67.9,111,62.1,234,65.1,2,0
959,2019-05-27 08:00:00,119,67.8,106,62.0,225,65.1,2,0
960,2019-05-27 08:05:00,117,67.6,105,61.8,222,64.9,2,0
961,2019-05-27 08:10:00,118,67.4,106,61.6,224,64.7,2,0
962,2019-05-27 08:15:00,119,67.4,106,61.6,225,64.7,2,0
963,2019-05-27 08:20:00,120,67.2,107,61.4,227,64.5,2,0
964,2019-05-27 08:25:00,118,67.1,106,61.3,224,64.4,2,0
965,2019-05-27 08:30:00,116,66.9,105,61.1,221,64.1,2,0
966,2019-05-27 08:35:00,117,66.8,105,61.0,222,64.1,2,0
967,2019-05-27 08:40:00,119,66.7,106,60.9,225,64.0,2,0
968,2019-05-27 08:45:00,119,66.7,106,60.9,225,64.0,2,0
969,2019-05-27 08:50:00,117,66.6,106,60.8,223,63.8,2,0
970,2019-05-27 08:55:00,114,66.6,102,60.8,216,63.9,2,0
971,2019-05-27 09:00:00,111,66.7,100,60.9,211,63.9,2,0
972,2019-05-27 09:05:00,110,66.7,98,60.9,208,64.0,2,0
973,2019-05-27 09:10:00,111,66.6,99,60.8,210,63.9,2,0
974,2019-05-27 09:15:00,112,66.4,100,60.8,212,63.8,2,0
975,2019-05-27 09:20:00,113,66.4,101,60.8,214,63.8,2,0
976,2019-05-27 09:25:00,113,66.4,102,60.8,215,63.7,2,0
977,2019-05-27 09:30:00,113,66.3,102,60.7,215,63.6,2,0
978,2019-05-27 09:35:00,115,66.3,103,60.7,218,63.7,2,0
979,2019-05-27 09:40:00,115,66.3,104,60.7,219,63.6,2,0
980,2019-05-27 09:45:00,116,66.4,104,60.8,220,63.8,2,0
981,2019-05-27 09:50:00,116,66.6,104,60.8,220,63.9,2,0
982,2019-05-27 09:55:00,113,66.6,102,60.8,215,63.8,2,0
983,2019-05-27 10:00:00,112,66.4,100,60.8,212,63.8,2,0
984,2019-05-27 10:05:00,111,66.4,100,60.8,211,63.7,2,0
985,2019-05-27 10:10:00,112,66.4,100,60.8,212,63.8,2,0
986,2019-05-27 10:15:00,114,66.4,102,60.8,216,63.8,2,0
987,2019-05-27 10:20:00,114,66.4,103,60.8,217,63.7,2,0
988,2019-05-27 10:25:00,114,66.4,102,60.8,216,63.8,2,0
989,2019-05-27 10:30:00,114,66.6,103,60.8,217,63.8,2,0
990,2019-05-27 10:35:00,115,66.6,104,60.8,219,63.8,2,0
991,2019-05-27 10:40:00,117,66.6,105,60.8,222,63.9,2,0
992,2019-05-27 10:45:00,116,66.6,105,60.8,221,63.8,2,0
993,2019-05-27 10:50:00,117,66.6,105,60.8,222,63.9,2,0
994,2019-05-27 10:55:00,114,66.7,102,60.9,216,64.0,2,0
995,2019-05-27 11:00:00,113,66.6,101,60.8,214,63.9,2,0
996,2019-05-27 11:05:00,113,66.4,101,60.8,214,63.8,2,0
997,2019-05-27 11:10:00,114,66.4,103,60.8,217,63.7,2,0
998,2019-05-27 11:15:00,115,66.4,104,60.8,219,63.7,2,0
999,2019-05-27 11:20:00,116,66.6,104,60.8,220,63.9,2,0
1000,2019-05-27 11:25:00,116,66.6,104,60.8,220,63.9,2,0
1001,2019-05-27 11:30:00,116,66.6,104,60.8,220,63.9,2,0
1002,2019-05-27 11:35:00,117,66.6,105,60.8,222,63.9,2,0
1003,2019-05-27 11:40:00,119,66.6,106,60.8,225,63.9,2,0
1004,2019-05-27 11:45:00,119,66.7,107,60.9,226,64.0,2,0
1005,2019-05-27 11:50:00,119,66.7,107,60.9,226,64.0,2,0
1006,2019-05-27 11:55:00,117,66.7,105,60.9,222,64.0,2,0
1007,2019-05-27 12:00:00,116,66.6,104,60.8,220,63.9,2,0
1008,2019-05-27 12:05:00,117,66.6,105,60.8,222,63.9,2,0
1009,2019-05-27 12:10:00,120,66.6,107,60.8,227,63.9,2,0
1010,2019-05-27 12:15:00,120,66.6,107,60.8,227,63.9,2,0
1011,2019-05-27 12:20:00,120,66.6,107,60.8,227,63.9,2,0
1012,2019-05-27 12:25:00,120,66.6,107,60.8,227,63.9,2,0
1013,2019-05-27 12:30:00,120,66.6,107,60.8,227,63.9,2,0
1014,2019-05-27 12:35:00,121,66.7,108,60.9,229,64.0,2,0
1015,2019-05-27 12:40:00,122,66.7,109,60.9,231,64.0,2,0
1016,2019-05-27 12:45:00,122,66.8,110,61.0,232,64.0,2,0
1017,2019-05-27 12:50:00,121,66.8,109,61.0,230,64.0,2,0
1018,2019-05-27 12:55:00,118,66.8,106,61.0,224,64.1,2,0
1019,2019-05-27 13:00:00,117,66.7,106,60.9,223,63.9,2,0
1020,2019-05-27 13:05:00,119,66.7,106,60.9,225,64.0,2,0
1021,2019-05-27 13:10:00,121,66.6,109,60.8,230,63.8,2,0
1022,2019-05-27 13:15:00,123,66.7,110,60.9,233,64.0,2,0
1023,2019-05-27 13:20:00,122,66.7,110,60.9,232,63.9,2,0
1024,2019-05-27 13:25:00,123,66.8,111,61.0,234,64.0,2,0
1025,2019-05-27 13:30:00,122,66.8,110,61.0,232,64.0,2,0
1026,2019-05-27 13:35:00,124,66.8,112,61.0,236,64.0,2,0
1027,2019-05-27 13:40:00,126,66.8,114,61.0,240,64.0,2,0
1028,2019-05-27 13:45:00,125,66.8,113,61.0,238,64.0,2,0
1029,2019-05-27 13:50:00,126,66.9,114,61.1,240,64.1,2,0
1030,2019-05-27 13:55:00,125,66.9,112,61.1,237,64.2,2,0
1031,2019-05-27 14:00:00,123,66.7,111,60.9,234,63.9,2,0
1032,2019-05-27 14:05:00,128,66.6,114,60.8,242,63.9,2,0
1033,2019-05-27 14:10:00,133,66.6,119,60.8,252,63.9,2,0
1034,2019-05-27 14:15:00,134,66.4,121,60.8,255,63.7,2,0
1035,2019-05-27 14:20:00,136,66.3,123,60.7,259,63.6,2,0
1036,2019-05-27 14:25:00,136,66.3,122,60.7,258,63.7,2,0
1037,2019-05-27 14:30:00,137,66.4,123,60.8,260,63.8,2,0
1038,2019-05-27 14:35:00,140,66.3,125,60.7,265,63.7,2,0
1039,2019-05-27 14:40:00,144,66.3,129,60.7,273,63.7,2,0
1040,2019-05-27 14:45:00,144,66.3,129,60.7,273,63.7,2,0
1041,2019-05-27 14:50:00,142,66.3,127,60.7,269,63.7,2,0
1042,2019-05-27 14:55:00,139,66.3,125,60.7,264,63.7,2,0
1043,2019-05-27 15:00:00,135,66.1,122,60.5,257,63.4,2,0
1044,2019-05-27 15:05:00,136,66.0,123,60.4,259,63.3,2,0
1045,2019-05-27 15:10:00,140,65.9,125,60.3,265,63.3,2,0
1046,2019-05-27 15:15:00,140,65.9,126,60.3,266,63.2,2,0
1047,2019-05-27 15:20:00,140,65.9,126,60.3,266,63.2,2,0
1048,2019-05-27 15:25:00,139,65.9,125,60.3,264,63.2,2,0
1049,2019-05-27 15:30:00,138,66.0,124,60.4,262,63.4,2,0
1050,2019-05-27 15:35:00,140,66.0,126,60.4,266,63.3,2,0
1051,2019-05-27 15:40:00,143,66.0,129,60.4,272,63.3,2,0
1052,2019-05-27 15:45:00,143,66.0,129,60.4,272,63.3,2,0
1053,2019-05-27 15:50:00,142,66.0,128,60.4,270,63.3,2,0
1054,2019-05-27 15:55:00,138,66.1,124,60.5,262,63.5,2,0
1055,2019-05-27 16:00:00,138,66.3,123,60.7,261,63.7,2,0
1056,2019-05-27 16:05:00,139,66.3,125,60.7,264,63.7,2,0
1057,2019-05-27 16:10:00,142,66.3,127,60.7,269,63.7,2,0
1058,2019-05-27 16:15:00,144,66.3,129,60.7,273,63.7,2,0
1059,2019-05-27 16:20:00,143,66.4,128,60.8,271,63.8,2,0
1060,2019-05-27 16:25:00,140,66.4,126,60.8,266,63.7,2,0
1061,2019-05-27 16:30:00,139,66.4,124,60.8,263,63.8,2,0
1062,2019-05-27 16:35:00,142,66.6,128,60.8,270,63.8,2,0
1063,2019-05-27 16:40:00,145,66.6,131,60.8,276,63.8,2,0
1064,2019-05-27 16:45:00,144,66.6,130,60.8,274,63.8,2,0
1065,2019-05-27 16:50:00,143,66.6,129,60.8,272,63.8,2,0
1066,2019-05-27 16:55:00,142,66.6,127,60.8,269,63.9,2,0
1067,2019-05-27 17:00:00,140,66.8,126,61.0,266,64.1,2,0
1068,2019-05-27 17:05:00,143,66.8,128,61.0,271,64.1,2,0
1069,2019-05-27 17:10:00,147,66.7,132,60.9,279,64.0,2,0
1070,2019-05-27 17:15:00,148,66.7,132,60.9,280,64.0,2,0
1071,2019-05-27 17:20:00,146,66.7,131,60.9,277,64.0,2,0
1072,2019-05-27 17:25:00,144,66.8,129,61.0,273,64.1,2,0
1073,2019-05-27 17:30:00,141,66.9,127,61.1,268,64.1,2,0
1074,2019-05-27 17:35:00,140,67.0,126,61.2,266,64.3,2,0
1075,2019-05-27 17:40:00,139,67.2,125,61.4,264,64.5,2,0
1076,2019-05-27 17:45:00,138,67.2,123,61.4,261,64.5,2,0
1077,2019-05-27 17:50:00,135,67.3,122,61.5,257,64.5,2,0
1078,2019-05-27 17:55:00,133,67.5,119,61.7,252,64.8,2,0
1079,2019-05-27 18:00:00,130,67.6,116,61.8,246,64.9,2,0
1080,2019-05-27 18:05:00,129,67.8,116,62.0,245,65.1,2,0
1081,2019-05-27 18:10:00,131,67.9,117,62.1,248,65.2,2,0
1082,2019-05-27 18:15:00,130,68.0,116,62.2,246,65.3,2,0
1083,2019-05-27 18:20:00,127,68.2,114,62.4,241,65.5,2,0
1084,2019-05-27 18:25:00,124,68.3,112,62.5,236,65.5,2,0
1085,2019-05-27 18:30:00,122,68.6,110,62.8,232,65.9,2,0
1086,2019-05-27 18:35:00,121,68.7,108,62.9,229,66.0,2,0
1087,2019-05-27 18:40:00,120,68.9,108,62.9,228,66.1,2,0
1088,2019-05-27 18:45:00,117,69.1,105,63.1,222,66.3,2,0
1089,2019-05-27 18:50:00,114,69.1,102,63.1,216,66.3,2,0
1090,2019-05-27 18:55:00,110,69.2,99,63.2,209,66.4,2,0
1091,2019-05-27 19:00:00,109,69.5,97,63.5,206,66.7,2,0
1092,2019-05-27 19:05:00,107,69.8,97,63.8,204,66.9,2,0
1093,2019-05-27 19:10:00,107,69.9,96,63.9,203,67.1,2,0
1094,2019-05-27 19:15:00,106,70.0,95,64.0,201,67.2,2,0
1095,2019-05-27 19:20:00,104,70.1,93,64.1,197,67.3,2,0
1096,2019-05-27 19:25:00,100,70.2,89,64.2,189,67.4,2,0
1097,2019-05-27 19:30:00,98,70.3,88,64.3,186,67.5,2,0
1098,2019-05-27 19:35:00,96,70.4,87,64.4,183,67.5,2,0
1099,2019-05-27 19:40:00,95,70.4,86,64.4,181,67.6,2,0
1100,2019-05-27 19:45:00,94,70.5,84,64.5,178,67.7,2,0
1101,2019-05-27 19:50:00,90,70.4,81,64.4,171,67.6,2,0
1102,2019-05-27 19:55:00,89,70.4,79,64.4,168,67.6,2,0
1103,2019-05-27 20:00:00,86,70.6,77,64.6,163,67.8,2,0
1104,2019-05-27 20:05:00,85,70.7,76,64.7,161,67.9,2,0
1105,2019-05-27 20:10:00,85,70.7,76,64.7,161,67.9,2,0
1106,2019-05-27 20:15:00,84,70.7,76,64.7,160,67.9,2,0
1107,2019-05-27 20:20:00,83,70.7,75,64.7,158,67.9,2,0
1108,2019-05-27 20:25:00,81,70.6,73,64.6,154,67.8,2,0
1109,2019-05-27 20:30:00,79,70.6,70,64.6,149,67.8,2,0
1110,2019-05-27 20:35:00,77,70.5,69,64.5,146,67.7,2,0
1111,2019-05-27 20:40:00,76,70.5,68,64.5,144,67.7,2,0
1112,2019-05-27 20:45:00,75,70.4,67,64.4,142,67.6,2,0
1113,2019-05-27 20:50:00,74,70.3,66,64.3,140,67.5,2,0
1114,2019-05-27 20:55:00,73,70.2,65,64.2,138,67.4,2,0
1115,2019-05-27 21:00:00,72,70.4,65,64.4,137,67.6,2,0
1116,2019-05-27 21:05:00,72,70.4,65,64.4,137,67.6,2,0
1117,2019-05-27 21:10:00,72,70.4,65,64.4,137,67.6,2,0
1118,2019-05-27 21:15:00,73,70.4,65,64.4,138,67.6,2,0
1119,2019-05-27 21:20:00,71,70.4,63,64.4,134,67.6,2,0
1120,2019-05-27 21:25:00,70,70.5,62,64.5,132,67.7,2,0
1121,2019-05-27 21:30:00,67,70.5,61,64.5,128,67.6,2,0
1122,2019-05-27 21:35:00,66,70.6,59,64.6,125,67.8,2,0
1123,2019-05-27 21:40:00,64,70.6,58,64.6,122,67.7,2,0
1124,2019-05-27 21:45:00,63,70.6,56,64.6,119,67.8,2,0
1125,2019-05-27 21:50:00,61,70.7,54,64.7,115,67.9,2,0
1126,2019-05-27 21:55:00,58,70.7,52,64.7,110,67.9,2,0
1127,2019-05-27 22:00:00,56,70.7,50,64.7,106,67.9,2,0
1128,2019-05-27 22:05:00,56,70.7,50,64.7,106,67.9,2,0
1129,2019-05-27 22:10:00,56,70.7,51,64.7,107,67.8,2,0
1130,2019-05-27 22:15:00,55,70.7,49,64.7,104,67.9,2,0
1131,2019-05-27 22:20:00,53,70.8,48,64.8,101,68.0,2,0
1132,2019-05-27 22:25:00,51,70.8,45,64.8,96,68.0,2,0
1133,2019-05-27 22:30:00,48,70.8,44,64.8,92,67.9,2,0
1134,2019-05-27 22:35:00,47,70.8,42,64.8,89,68.0,2,0
1135,2019-05-27 22:40:00,46,70.8,41,64.8,87,68.0,2,0
1136,2019-05-27 22:45:00,44,70.8,40,64.8,84,67.9,2,0
1137,2019-05-27 22:50:00,42,70.8,37,64.8,79,68.0,2,0
1138,2019-05-27 22:55:00,38,70.8,35,64.8,73,67.9,2,0
1139,2019-05-27 23:00:00,37,70.7,33,64.7,70,67.9,2,0
1140,2019-05-27 23:05:00,36,70.7,33,64.7,69,67.8,2,0
1141,2019-05-27 23:10:00,36,70.7,32,64.7,68,67.9,2,0
1142,2019-05-27 23:15:00,34,70.7,31,64.7,65,67.8,2,0
1143,2019-05-27 23:20:00,33,70.7,29,64.7,62,67.9,2,0
1144,2019-05-27 23:25:00,31,70.7,27,64.7,58,67.9,2,0
1145,2019-05-27 23:30:00,29,70.7,26,64.7,55,67.9,2,0
1146,2019-05-27 23:35:00,28,70.7,26,64.7,54,67.8,2,0
1147,2019-05-27 23:40:00,28,70.7,26,64.7,54,67.8,2,0
1148,2019-05-27 23:45:00,26,70.7,24,64.7,50,67.8,2,0
1149,2019-05-27 23:50:00,25,70.7,22,64.7,47,67.9,2,0
1150,2019-05-27 23:55:00,23,70.6,21,64.6,44,67.7,2,0
1151,2019-05-28 00:00:00,22,71.2,20,65.0,42,68.2,2,0
1152,2019-05-28 00:05:00,22,71.0,19,65.0,41,68.2,2,0
1153,2019-05-28 00:10:00,21,70.9,19,64.9,40,68.1,2,0
1154,2019-05-28 00:15:00,19,70.8,18,64.8,37,67.9,2,0
1155,2019-05-28 00:20:00,18,70.8,17,64.8,35,67.9,2,0
1156,2019-05-28 00:25:00,17,70.7,16,64.7,33,67.8,2,0
1157,2019-05-28 00:30:00,16,70.6,14,64.6,30,67.8,2,0
1158,2019-05-28 00:35:00,15,70.6,13,64.6,28,67.8,2,0
1159,2019-05-28 00:40:00,14,70.6,13,64.6,27,67.7,2,0
1160,2019-05-28 00:45:00,14,70.6,12,64.6,26,67.8,2,0
1161,2019-05-28 00:50:00,13,70.6,11,64.6,24,67.9,2,0
1162,2019-05-28 00:55:00,12,70.6,11,64.6,23,67.7,2,0
1163,2019-05-28 01:00:00,11,70.6,10,64.6,21,67.7,2,0
1164,2019-05-28 01:05:00,11,70.6,10,64.6,21,67.7,2,0
1165,2019-05-28 01:10:00,11,70.6,9,64.6,20,67.9,2,0
1166,2019-05-28 01:15:00,10,70.6,9,64.6,19,67.8,2,0
1167,2019-05-28 01:20:00,9,70.6,9,64.6,18,67.6,2,0
1168,2019-05-28 01:25:00,9,70.6,9,64.6,18,67.6,2,0
1169,2019-05-28 01:30:00,9,70.6,8,64.6,17,67.8,2,0
1170,2019-05-28 01:35:00,9,70.5,8,64.5,17,67.7,2,0
1171,2019-05-28 01:40:00,9,70.5,8,64.5,17,67.7,2,0
1172,2019-05-28 01:45:00,8,70.5,8,64.5,16,67.5,2,0
1173,2019-05-28 01:50:00,8,70.5,8,64.5,16,67.5,2,0
1174,2019-05-28 01:55:00,8,70.4,7,64.4,15,67.6,2,0
1175,2019-05-28 02:00:00,8,70.5,7,64.5,15,67.7,2,0
1176,2019-05-28 02:05:00,8,70.5,7,64.5,15,67.7,2,0
1177,2019-05-28 02:10:00,8,70.5,7,64.5,15,67.7,2,0
1178,2019-05-28 02:15:00,8,70.5,7,64.5,15,67.7,2,0
1179,2019-05-28 02:20:00,8,70.5,7,64.5,15,67.7,2,0
1180,2019-05-28 02:25:00,7,70.5,7,64.5,14,67.5,2,0
1181,2019-05-28 02:30:00,7,70.4,7,64.4,14,67.4,2,0
1182,2019-05-28 02:35:00,8,70.4,7,64.4,15,67.6,2,0
1183,2019-05-28 02:40:00,8,70.5,7,64.5,15,67.7,2,0
1184,2019-05-28 02:45:00,8,70.4,7,64.4,15,67.6,2,0
1185,2019-05-28 02:50:00,8,70.4,7,64.4,15,67.6,2,0
1186,2019-05-28 02:55:00,7,70.4,7,64.4,14,67.4,2,0
1187,2019-05-28 03:00:00,7,70.4,7,64.4,14,67.4,2,0
1188,2019-05-28 03:05:00,7,70.4,7,64.4,14,67.4,2,0
1189,2019-05-28 03:10:00,7,70.4,7,64.4,14,67.4,2,0
1190,2019-05-28 03:15:00,8,70.4,7,64.4,15,67.6,2,0
1191,2019-05-28 03:20:00,8,70.4,8,64.4,16,67.4,2,0
1192,2019-05-28 03:25:00,8,70.4,8,64.4,16,67.4,2,0
1193,2019-05-28 03:30:00,9,70.4,9,64.4,18,67.4,2,0
1194,2019-05-28 03:35:00,10,70.4,9,64.4,19,67.6,2,0
1195,2019-05-28 03:40:00,12,70.4,10,64.4,22,67.7,2,0
1196,2019-05-28 03:45:00,12,70.5,11,64.5,23,67.6,2,0
1197,2019-05-28 03:50:00,13,70.5,11,64.5,24,67.8,2,0
1198,2019-05-28 03:55:00,13,70.5,11,64.5,24,67.8,2,0
1199,2019-05-28 04:00:00,12,70.3,11,64.3,23,67.4,2,0
1200,2019-05-28 04:05:00,13,70.3,12,64.3,25,67.4,2,0
1201,2019-05-28 04:10:00,14,70.4,13,64.4,27,67.5,2,0
1202,2019-05-28 04:15:00,16,70.4,14,64.4,30,67.6,2,0
1203,2019-05-28 04:20:00,17,70.4,16,64.4,33,67.5,2,0
1204,2019-05-28 04:25:00,18,70.5,17,64.5,35,67.6,2,0
1205,2019-05-28 04:30:00,21,70.5,18,64.5,39,67.7,2,0
1206,2019-05-28 04:35:00,23,70.6,20,64.6,43,67.8,2,0
1207,2019-05-28 04:40:00,26,70.7,24,64.7,50,67.8,2,0
1208,2019-05-28 04:45:00,28,70.8,25,64.8,53,68.0,2,0
1209,2019-05-28 04:50:00,30,70.8,26,64.8,56,68.0,2,0
1210,2019-05-28 04:55:00,30,70.7,27,64.7,57,67.9,2,0
1211,2019-05-28 05:00:00,31,70.6,27,64.6,58,67.8,2,0
1212,2019-05-28 05:05:00,33,70.6,30,64.6,63,67.7,2,0
1213,2019-05-28 05:10:00,37,70.5,34,64.5,71,67.6,2,0
1214,2019-05-28 05:15:00,41,70.5,36,64.5,77,67.7,2,0
1215,2019-05-28 05:20:00,44,70.5,40,64.5,84,67.6,2,0
1216,2019-05-28 05:25:00,46,70.5,42,64.5,88,67.6,2,0
1217,2019-05-28 05:30:00,51,70.5,45,64.5,96,67.7,2,0
1218,2019-05-28 05:35:00,55,70.6,50,64.6,105,67.7,2,0
1219,2019-05-28 05:40:00,60,70.6,53,64.6,113,67.8,2,0
1220,2019-05-28 05:45:00,62,70.8,56,64.8,118,68.0,2,0
1221,2019-05-28 05:50:00,64,70.8,57,64.8,121,68.0,2,0
1222,2019-05-28 05:55:00,62,70.8,56,64.8,118,68.0,2,0
1223,2019-05-28 06:00:00,62,69.8,56,63.8,118,67.0,2,0
1224,2019-05-28 06:05:00,65,69.4,59,63.4,124,66.5,2,0
1225,2019-05-28 06:10:00,71,69.3,63,63.3,134,66.5,2,0
1226,2019-05-28 06:15:00,75,69.2,68,63.2,143,66.3,2,0
1227,2019-05-28 06:20:00,79,69.1,70,63.1,149,66.3,2,0
1228,2019-05-28 06:25:00,83,69.1,74,63.1,157,66.3,2,0
1229,2019-05-28 06:30:00,87,69.0,79,63.0,166,66.1,2,0
1230,2019-05-28 06:35:00,93,69.0,83,63.0,176,66.2,2,0
1231,2019-05-28 06:40:00,100,69.1,89,63.1,189,66.3,2,0
1232,2019-05-28 06:45:00,102,69.2,92,63.2,194,66.4,2,0
1233,2019-05-28 06:50:00,102,69.3,92,63.3,194,66.5,2,0
1234,2019-05-28 06:55:00,100,69.3,89,63.3,189,66.5,2,0
1235,2019-05-28 07:00:00,98,68.6,88,62.8,186,65.9,2,0
1236,2019-05-28 07:05:00,101,68.2,91,62.4,192,65.5,2,0
1237,2019-05-28 07:10:00,107,68.0,97,62.2,204,65.2,2,0
1238,2019-05-28 07:15:00,112,67.9,101,62.1,213,65.2,2,0
1239,2019-05-28 07:20:00,117,67.8,105,62.0,222,65.1,2,0
1240,2019-05-28 07:25:00,119,67.7,107,61.9,226,65.0,2,0
1241,2019-05-28 07:30:00,119,67.7,106,61.9,225,65.0,2,0
1242,2019-05-28 07:35:00,123,67.7,110,61.9,233,65.0,2,0
1243,2019-05-28 07:40:00,127,67.6,114,61.8,241,64.9,2,0
1244,2019-05-28 07:45:00,131,67.6,117,61.8,248,64.9,2,0
1245,2019-05-28 07:50:00,131,67.6,118,61.8,249,64.9,2,0
1246,2019-05-28 07:55:00,127,67.6,114,61.8,241,64.9,2,0
1247,2019-05-28 08:00:00,122,67.5,109,61.7,231,64.8,2,0
1248,2019-05-28 08:05:00,122,67.3,110,61.5,232,64.5,2,0
1249,2019-05-28 08:10:00,122,67.2,109,61.4,231,64.5,2,0
1250,2019-05-28 08:15:00,124,67.1,112,61.3,236,64.3,2,0
1251,2019-05-28 08:20:00,124,66.9,112,61.1,236,64.1,2,0
1252,2019-05-28 08:25:00,122,66.8,110,61.0,232,64.0,2,0
1253,2019-05-28 08:30:00,120,66.6,107,60.8,227,63.9,2,0
1254,2019-05-28 08:35:00,121,66.3,108,60.7,229,63.7,2,0
1255,2019-05-28 08:40:00,121,66.2,109,60.6,230,63.5,2,0
1256,2019-05-28 08:45:00,120,66.2,108,60.6,228,63.5,2,0
1257,2019-05-28 08:50:00,119,66.2,107,60.6,226,63.6,2,0
1258,2019-05-28 08:55:00,116,66.1,104,60.5,220,63.5,2,0
1259,2019-05-28 09:00:00,112,66.4,101,60.8,213,63.7,2,0
1260,2019-05-28 09:05:00,111,66.3,99,60.7,210,63.7,2,0
1261,2019-05-28 09:10:00,112,66.2,101,60.6,213,63.5,2,0
1262,2019-05-28 09:15:00,112,66.2,101,60.6,213,63.5,2,0
1263,2019-05-28 09:20:00,113,66.2,102,60.6,215,63.5,2,0
1264,2019-05-28 09:25:00,113,66.1,102,60.5,215,63.4,2,0
1265,2019-05-28 09:30:00,113,66.0,101,60.4,214,63.4,2,0
1266,2019-05-28 09:35:00,113,66.1,102,60.5,215,63.4,2,0
1267,2019-05-28 09:40:00,114,66.1,102,60.5,216,63.5,2,0
1268,2019-05-28 09:45:00,115,66.1,104,60.5,219,63.4,2,0
1269,2019-05-28 09:50:00,114,66.2,103,60.6,217,63.5,2,0
1270,2019-05-28 09:55:00,111,66.2,100,60.6,211,63.5,2,0
1271,2019-05-28 10:00:00,109,66.3,98,60.7,207,63.7,2,0
1272,2019-05-28 10:05:00,109,66.3,98,60.7,207,63.7,2,0
1273,2019-05-28 10:10:00,110,66.4,99,60.8,209,63.7,2,0
1274,2019-05-28 10:15:00,111,66.6,100,60.8,211,63.8,2,0
1275,2019-05-28 10:20:00,111,66.6,99,60.8,210,63.9,2,0
1276,2019-05-28 10:25:00,110,66.8,99,61.0,209,64.1,2,0
1277,2019-05-28 10:30:00,110,66.8,98,61.0,208,64.1,2,0
1278,2019-05-28 10:35:00,113,66.8,101,61.0,214,64.1,2,0
1279,2019-05-28 10:40:00,112,66.9,101,61.1,213,64.1,2,0
1280,2019-05-28 10:45:00,113,66.9,102,61.1,215,64.1,2,0
1281,2019-05-28 10:50:00,113,66.9,101,61.1,214,64.2,2,0
1282,2019-05-28 10:55:00,110,66.8,99,61.0,209,64.1,2,0
1283,2019-05-28 11:00:00,107,66.9,97,61.1,204,64.1,2,0
1284,2019-05-28 11:05:00,108,66.8,97,61.0,205,64.1,2,0
1285,2019-05-28 11:10:00,111,66.8,99,61.0,210,64.1,2,0
1286,2019-05-28 11:15:00,112,66.8,100,61.0,212,64.1,2,0
1287,2019-05-28 11:20:00,112,67.0,100,61.2,212,64.3,2,0
1288,2019-05-28 11:25:00,112,66.9,100,61.1,212,64.2,2,0
1289,2019-05-28 11:30:00,113,66.9,101,61.1,214,64.2,2,0
1290,2019-05-28 11:35:00,114,66.9,102,61.1,216,64.2,2,0
1291,2019-05-28 11:40:00,116,66.9,104,61.1,220,64.2,2,0
1292,2019-05-28 11:45:00,114,66.9,102,61.1,216,64.2,2,0
1293,2019-05-28 11:50:00,114,66.9,103,61.1,217,64.1,2,0
1294,2019-05-28 11:55:00,113,66.9,102,61.1,215,64.1,2,0
1295,2019-05-28 12:00:00,113,66.9,101,61.1,214,64.2,2,0
1296,2019-05-28 12:05:00,113,66.9,102,61.1,215,64.1,2,0
1297,2019-05-28 12:10:00,117,66.8,105,61.0,222,64.1,2,0
1298,2019-05-28 12:15:00,118,66.8,106,61.0,224,64.1,2,0
1299,2019-05-28 12:20:00,119,66.7,106,60.9,225,64.0,2,0
1300,2019-05-28 12:25:00,116,66.7,105,60.9,221,63.9,2,0
1301,2019-05-28 12:30:00,117,66.9,105,61.1,222,64.2,2,0
1302,2019-05-28 12:35:00,118,67.0,106,61.2,224,64.3,2,0
1303,2019-05-28 12:40:00,120,67.0,108,61.2,228,64.3,2,0
1304,2019-05-28 12:45:00,120,67.0,108,61.2,228,64.3,2,0
1305,2019-05-28 12:50:00,119,67.0,106,61.2,225,64.3,2,0
1306,2019-05-28 12:55:00,116,67.1,104,61.3,220,64.4,2,0
1307,2019-05-28 13:00:00,115,66.9,104,61.1,219,64.1,2,0
1308,2019-05-28 13:05:00,115,66.8,104,61.0,219,64.0,2,0
1309,2019-05-28 13:10:00,119,66.7,107,60.9,226,64.0,2,0
1310,2019-05-28 13:15:00,121,66.7,108,60.9,229,64.0,2,0
1311,2019-05-28 13:20:00,122,66.8,109,61.0,231,64.1,2,0
1312,2019-05-28 13:25:00,121,66.8,109,61.0,230,64.0,2,0
1313,2019-05-28 13:30:00,122,66.8,109,61.0,231,64.1,2,0
1314,2019-05-28 13:35:00,123,66.8,111,61.0,234,64.0,2,0
1315,2019-05-28 13:40:00,126,66.8,114,61.0,240,64.0,2,0
1316,2019-05-28 13:45:00,127,66.8,114,61.0,241,64.1,2,0
1317,2019-05-28 13:50:00,128,66.8,114,61.0,242,64.1,2,0
1318,2019-05-28 13:55:00,125,66.8,112,61.0,237,64.1,2,0
1319,2019-05-28 14:00:00,125,66.4,112,60.8,237,63.8,2,0
1320,2019-05-28 14:05:00,127,66.3,114,60.7,241,63.7,2,0
1321,2019-05-28 14:10:00,131,66.3,117,60.7,248,63.7,2,0
1322,2019-05-28 14:15:00,135,66.2,121,60.6,256,63.6,2,0
1323,2019-05-28 14:20:00,136,66.1,123,60.5,259,63.4,2,0
1324,2019-05-28 14:25:00,136,66.2,123,60.6,259,63.5,2,0
1325,2019-05-28 14:30:00,136,66.2,123,60.6,259,63.5,2,0
1326,2019-05-28 14:35:00,141,66.2,127,60.6,268,63.5,2,0
1327,2019-05-28 14:40:00,143,66.2,129,60.6,272,63.5,2,0
1328,2019-05-28 14:45:00,144,66.2,129,60.6,273,63.6,2,0
1329,2019-05-28 14:50:00,141,66.2,127,60.6,268,63.5,2,0
1330,2019-05-28 14:55:00,139,66.2,124,60.6,263,63.6,2,0
1331,2019-05-28 15:00:00,136,66.1,122,60.5,258,63.5,2,0
1332,2019-05-28 15:05:00,136,66.0,123,60.4,259,63.3,2,0
1333,2019-05-28 15:10:00,140,65.9,125,60.3,265,63.3,2,0
1334,2019-05-28 15:15:00,141,65.9,126,60.3,267,63.3,2,0
1335,2019-05-28 15:20:00,140,65.9,126,60.3,266,63.2,2,0
1336,2019-05-28 15:25:00,139,66.0,124,60.4,263,63.4,2,0
1337,2019-05-28 15:30:00,138,66.0,124,60.4,262,63.4,2,0
1338,2019-05-28 15:35:00,141,65.9,126,60.3,267,63.3,2,0
1339,2019-05-28 15:40:00,144,65.9,130,60.3,274,63.2,2,0
1340,2019-05-28 15:45:00,144,65.8,129,60.2,273,63.2,2,0
1341,2019-05-28 15:50:00,142,65.9,128,60.3,270,63.2,2,0
1342,2019-05-28 15:55:00,139,66.1,125,60.5,264,63.5,2,0
1343,2019-05-28 16:00:00,137,66.2,123,60.6,260,63.6,2,0
1344,2019-05-28 16:05:00,138,66.3,124,60.7,262,63.7,2,0
1345,2019-05-28 16:10:00,140,66.2,126,60.6,266,63.5,2,0
1346,2019-05-28 16:15:00,142,66.3,127,60.7,269,63.7,2,0
1347,2019-05-28 16:20:00,142,66.3,128,60.7,270,63.6,2,0
1348,2019-05-28 16:25:00,140,66.4,125,60.8,265,63.8,2,0
1349,2019-05-28 16:30:00,140,66.6,125,60.8,265,63.9,2,0
1350,2019-05-28 16:35:00,142,66.6,127,60.8,269,63.9,2,0
1351,2019-05-28 16:40:00,146,66.6,131,60.8,277,63.9,2,0
1352,2019-05-28 16:45:00,146,66.6,131,60.8,277,63.9,2,0
1353,2019-05-28 16:50:00,144,66.6,129,60.8,273,63.9,2,0
1354,2019-05-28 16:55:00,141,66.7,126,60.9,267,64.0,2,0
1355,2019-05-28 17:00:00,140,66.7,125,60.9,265,64.0,2,0
1356,2019-05-28 17:05:00,143,66.7,129,60.9,272,63.9,2,0
1357,2019-05-28 17:10:00,148,66.7,132,60.9,280,64.0,2,0
1358,2019-05-28 17:15:00,148,66.6,132,60.8,280,63.9,2,0
1359,2019-05-28 17:20:00,145,66.6,131,60.8,276,63.8,2,0
1360,2019-05-28 17:25:00,143,66.8,128,61.0,271,64.1,2,0
1361,2019-05-28 17:30:00,141,66.8,127,61.0,268,64.0,2,0
1362,2019-05-28 17:35:00,140,66.9,126,61.1,266,64.2,2,0
1363,2019-05-28 17:40:00,139,67.0,125,61.2,264,64.3,2,0
1364,2019-05-28 17:45:00,138,67.1,123,61.3,261,64.4,2,0
1365,2019-05-28 17:50:00,135,67.2,122,61.4,257,64.4,2,0
1366,2019-05-28 17:55:00,133,67.4,119,61.6,252,64.7,2,0
1367,2019-05-28 18:00:00,131,67.5,117,61.7,248,64.8,2,0
1368,2019-05-28 18:05:00,130,67.6,117,61.8,247,64.9,2,0
1369,2019-05-28 18:10:00,131,67.8,117,62.0,248,65.1,2,0
1370,2019-05-28 18:15:00,131,67.9,117,62.1,248,65.2,2,0
1371,2019-05-28 18:20:00,129,68.0,115,62.2,244,65.3,2,0
1372,2019-05-28 18:25:00,126,68.1,114,62.3,240,65.3,2,0
1373,2019-05-28 18:30:00,123,68.4,110,62.6,233,65.7,2,0
1374,2019-05-28 18:35:00,122,68.5,110,62.7,232,65.8,2,0
1375,2019-05-28 18:40:00,121,68.7,109,62.9,230,66.0,2,0
1376,2019-05-28 18:45:00,119,68.7,106,62.9,225,66.0,2,0
1377,2019-05-28 18:50:00,117,69.0,106,63.0,223,66.1,2,0
1378,2019-05-28 18:55:00,114,69.1,102,63.1,216,66.3,2,0
1379,2019-05-28 19:00:00,111,69.5,99,63.5,210,66.7,2,0
1380,2019-05-28 19:05:00,109,69.7,98,63.7,207,66.9,2,0
1381,2019-05-28 19:10:00,110,69.7,98,63.7,208,66.9,2,0
1382,2019-05-28 19:15:00,109,69.8,97,63.8,206,67.0,2,0
1383,2019-05-28 19:20:00,106,69.9,95,63.9,201,67.1,2,0
1384,2019-05-28 19:25:00,104,70.0,93,64.0,197,67.2,2,0
1385,2019-05-28 19:30:00,100,70.1,90,64.1,190,67.3,2,0
1386,2019-05-28 19:35:00,99,70.1,88,64.1,187,67.3,2,0
1387,2019-05-28 19:40:00,97,70.2,88,64.2,185,67.3,2,0
1388,2019-05-28 19:45:00,95,70.2,86,64.2,181,67.3,2,0
1389,2019-05-28 19:50:00,94,70.3,84,64.3,178,67.5,2,0
1390,2019-05-28 19:55:00,91,70.3,81,64.3,172,67.5,2,0
1391,2019-05-28 20:00:00,89,70.4,80,64.4,169,67.6,2,0
1392,2019-05-28 20:05:00,88,70.5,79,64.5,167,67.7,2,0
1393,2019-05-28 20:10:00,90,70.5,80,64.5,170,67.7,2,0
1394,2019-05-28 20:15:00,87,70.5,79,64.5,166,67.6,2,0
1395,2019-05-28 20:20:00,87,70.5,79,64.5,166,67.6,2,0
1396,2019-05-28 20:25:00,86,70.4,77,64.4,163,67.6,2,0
1397,2019-05-28 20:30:00,83,70.4,74,64.4,157,67.6,2,0
1398,2019-05-28 20:35:00,82,70.4,73,64.4,155,67.6,2,0
1399,2019-05-28 20:40:00,81,70.4,73,64.4,154,67.6,2,0
1400,2019-05-28 20:45:00,80,70.2,71,64.2,151,67.4,2,0
1401,2019-05-28 20:50:00,77,70.1,70,64.1,147,67.2,2,0
1402,2019-05-28 20:55:00,77,70.1,69,64.1,146,67.3,2,0
1403,2019-05-28 21:00:00,76,70.3,68,64.3,144,67.5,2,0
1404,2019-05-28 21:05:00,75,70.4,67,64.4,142,67.6,2,0
1405,2019-05-28 21:10:00,75,70.4,68,64.4,143,67.5,2,0
1406,2019-05-28 21:15:00,75,70.4,68,64.4,143,67.5,2,0
1407,2019-05-28 21:20:00,74,70.4,67,64.4,141,67.5,2,0
1408,2019-05-28 21:25:00,72,70.5,65,64.5,137,67.7,2,0
1409,2019-05-28 21:30:00,70,70.5,63,64.5,133,67.7,2,0
1410,2019-05-28 21:35:00,68,70.6,61,64.6,129,67.8,2,0
1411,2019-05-28 21:40:00,67,70.6,60,64.6,127,67.8,2,0
1412,2019-05-28 21:45:00,65,70.7,59,64.7,124,67.8,2,0
1413,2019-05-28 21:50:00,63,70.7,57,64.7,120,67.9,2,0
1414,2019-05-28 21:55:00,62,70.7,55,64.7,117,67.9,2,0
1415,2019-05-28 22:00:00,59,70.7,53,64.7,112,67.9,2,0
1416,2019-05-28 22:05:00,60,70.7,53,64.7,113,67.9,2,0
1417,2019-05-28 22:10:00,61,70.8,54,64.8,115,68.0,2,0
1418,2019-05-28 22:15:00,60,70.7,53,64.7,113,67.9,2,0
1419,2019-05-28 22:20:00,57,70.8,52,64.8,109,67.9,2,0
1420,2019-05-28 22:25:00,54,70.8,49,64.8,103,67.9,2,0
1421,2019-05-28 22:30:00,53,70.8,47,64.8,100,68.0,2,0
1422,2019-05-28 22:35:00,52,70.8,46,64.8,98,68.0,2,0
1423,2019-05-28 22:40:00,50,70.8,45,64.8,95,68.0,2,0
1424,2019-05-28 22:45:00,48,70.9,44,64.9,92,68.0,2,0
1425,2019-05-28 22:50:00,45,70.8,41,64.8,86,67.9,2,0
1426,2019-05-28 22:55:00,43,70.8,38,64.8,81,68.0,2,0
1427,2019-05-28 23:00:00,41,70.8,36,64.8,77,68.0,2,0
1428,2019-05-28 23:05:00,40,70.8,36,64.8,76,68.0,2,0
1429,2019-05-28 23:10:00,40,70.8,36,64.8,76,68.0,2,0
1430,2019-05-28 23:15:00,38,70.8,35,64.8,73,67.9,2,0
1431,2019-05-28 23:20:00,37,70.8,33,64.8,70,68.0,2,0
1432,2019-05-28 23:25:00,34,70.7,31,64.7,65,67.8,2,0
1433,2019-05-28 23:30:00,33,70.7,29,64.7,62,67.9,2,0
1434,2019-05-28 23:35:00,32,70.7,28,64.7,60,67.9,2,0
1435,2019-05-28 23:40:00,32,70.7,28,64.7,60,67.9,2,0
1436,2019-05-28 23:45:00,30,70.7,27,64.7,57,67.9,2,0
1437,2019-05-28 23:50:00,28,70.7,25,64.7,53,67.9,2,0
1438,2019-05-28 23:55:00,26,70.6,23,64.6,49,67.8,2,0
1439,2019-05-29 00:00:00,24,71.2,22,65.0,46,68.2,2,0
1440,2019-05-29 00:05:00,24,71.0,21,65.0,45,68.2,2,0
1441,2019-05-29 00:10:00,23,70.9,20,64.9,43,68.1,2,0
1442,2019-05-29 00:15:00,21,70.9,19,64.9,40,68.1,2,0
1443,2019-05-29 00:20:00,19,70.8,18,64.8,37,67.9,2,0
1444,2019-05-29 00:25:00,18,70.8,17,64.8,35,67.9,2,0
1445,2019-05-29 00:30:00,17,70.7,15,64.7,32,67.9,2,0
1446,2019-05-29 00:35:00,16,70.7,14,64.7,30,67.9,2,0
1447,2019-05-29 00:40:00,15,70.6,14,64.6,29,67.7,2,0
1448,2019-05-29 00:45:00,14,70.6,13,64.6,27,67.7,2,0
1449,2019-05-29 00:50:00,14,70.6,12,64.6,26,67.8,2,0
1450,2019-05-29 00:55:00,13,70.6,11,64.6,24,67.9,2,0
1451,2019-05-29 01:00:00,12,70.6,10,64.6,22,67.9,2,0
1452,2019-05-29 01:05:00,12,70.6,10,64.6,22,67.9,2,0
1453,2019-05-29 01:10:00,11,70.7,10,64.7,21,67.8,2,0
1454,2019-05-29 01:15:00,11,70.6,9,64.6,20,67.9,2,0
1455,2019-05-29 01:20:00,10,70.6,9,64.6,19,67.8,2,0
1456,2019-05-29 01:25:00,9,70.5,9,64.5,18,67.5,2,0
1457,2019-05-29 01:30:00,9,70.5,9,64.5,18,67.5,2,0
1458,2019-05-29 01:35:00,9,70.5,8,64.5,17,67.7,2,0
1459,2019-05-29 01:40:00,9,70.5,8,64.5,17,67.7,2,0
1460,2019-05-29 01:45:00,8,70.5,8,64.5,16,67.5,2,0
1461,2019-05-29 01:50:00,8,70.4,8,64.4,16,67.4,2,0
1462,2019-05-29 01:55:00,8,70.4,8,64.4,16,67.4,2,0
1463,2019-05-29 02:00:00,8,70.5,7,64.5,15,67.7,2,0
1464,2019-05-29 02:05:00,8,70.5,7,64.5,15,67.7,2,0
1465,2019-05-29 02:10:00,8,70.5,7,64.5,15,67.7,2,0
1466,2019-05-29 02:15:00,8,70.5,7,64.5,15,67.7,2,0
1467,2019-05-29 02:20:00,8,70.5,7,64.5,15,67.7,2,0
1468,2019-05-29 02:25:00,8,70.5,7,64.5,15,67.7,2,0
1469,2019-05-29 02:30:00,8,70.4,7,64.4,15,67.6,2,0
1470,2019-05-29 02:35:00,8,70.4,7,64.4,15,67.6,2,0
1471,2019-05-29 02:40:00,8,70.5,8,64.5,16,67.5,2,0
1472,2019-05-29 02:45:00,8,70.4,7,64.4,15,67.6,2,0
1473,2019-05-29 02:50:00,8,70.5,7,64.5,15,67.7,2,0
1474,2019-05-29 02:55:00,8,70.4,7,64.4,15,67.6,2,0
1475,2019-05-29 03:00:00,7,70.4,7,64.4,14,67.4,2,0
1476,2019-05-29 03:05:00,7,70.4,7,64.4,14,67.4,2,0
1477,2019-05-29 03:10:00,8,70.4,7,64.4,15,67.6,2,0
1478,2019-05-29 03:15:00,8,70.4,7,64.4,15,67.6,2,0
1479,2019-05-29 03:20:00,8,70.4,8,64.4,16,67.4,2,0
1480,2019-05-29 03:25:00,9,70.4,8,64.4,17,67.6,2,0
1481,2019-05-29 03:30:00,9,70.4,9,64.4,18,67.4,2,0
1482,2019-05-29 03:35:00,11,70.4,9,64.4,20,67.7,2,0
1483,2019-05-29 03:40:00,12,70.5,10,64.5,22,67.8,2,0
1484,2019-05-29 03:45:00,12,70.5,11,64.5,23,67.6,2,0
1485,2019-05-29 03:50:00,13,70.5,11,64.5,24,67.8,2,0
1486,2019-05-29 03:55:00,13,70.5,11,64.5,24,67.8,2,0
1487,2019-05-29 04:00:00,13,70.4,11,64.4,24,67.7,2,0
1488,2019-05-29 04:05:00,13,70.4,12,64.4,25,67.5,2,0
1489,2019-05-29 04:10:00,15,70.4,13,64.4,28,67.6,2,0
1490,2019-05-29 04:15:00,16,70.4,15,64.4,31,67.5,2,0
1491,2019-05-29 04:20:00,18,70.5,16,64.5,34,67.7,2,0
1492,2019-05-29 04:25:00,19,70.5,18,64.5,37,67.6,2,0
1493,2019-05-29 04:30:00,21,70.6,19,64.6,40,67.8,2,0
1494,2019-05-29 04:35:00,24,70.7,21,64.7,45,67.9,2,0
1495,2019-05-29 04:40:00,27,70.8,24,64.8,51,68.0,2,0
1496,2019-05-29 04:45:00,30,70.9,26,64.9,56,68.1,2,0
1497,2019-05-29 04:50:00,32,70.9,28,64.9,60,68.1,2,0
1498,2019-05-29 04:55:00,33,70.8,29,64.8,62,68.0,2,0
1499,2019-05-29 05:00:00,34,70.7,30,64.7,64,67.9,2,0
1500,2019-05-29 05:05:00,36,70.6,32,64.6,68,67.8,2,0
1501,2019-05-29 05:10:00,40,70.6,35,64.6,75,67.8,2,0
1502,2019-05-29 05:15:00,44,70.6,39,64.6,83,67.8,2,0
1503,2019-05-29 05:20:00,47,70.6,43,64.6,90,67.7,2,0
1504,2019-05-29 05:25:00,51,70.6,45,64.6,96,67.8,2,0
1505,2019-05-29 05:30:00,54,70.7,49,64.7,103,67.8,2,0
1506,2019-05-29 05:35:00,59,70.7,53,64.7,112,67.9,2,0
1507,2019-05-29 05:40:00,64,70.7,57,64.7,121,67.9,2,0
1508,2019-05-29 05:45:00,67,70.8,60,64.8,127,68.0,2,0
1509,2019-05-29 05:50:00,67,70.9,61,64.9,128,68.0,2,0
1510,2019-05-29 05:55:00,66,70.9,60,64.9,126,68.0,2,0
1511,2019-05-29 06:00:00,66,69.9,59,63.9,125,67.1,2,0
1512,2019-05-29 06:05:00,68,69.4,62,63.4,130,66.5,2,0
1513,2019-05-29 06:10:00,74,69.3,66,63.3,140,66.5,2,0
1514,2019-05-29 06:15:00,80,69.2,71,63.2,151,66.4,2,0
1515,2019-05-29 06:20:00,85,69.1,76,63.1,161,66.3,2,0
1516,2019-05-29 06:25:00,88,69.1,79,63.1,167,66.3,2,0
1517,2019-05-29 06:30:00,92,69.1,83,63.1,175,66.3,2,0
1518,2019-05-29 06:35:00,98,69.1,88,63.1,186,66.3,2,0
1519,2019-05-29 06:40:00,104,69.2,93,63.2,197,66.4,2,0
1520,2019-05-29 06:45:00,107,69.3,96,63.3,203,66.5,2,0
1521,2019-05-29 06:50:00,107,69.4,96,63.4,203,66.6,2,0
1522,2019-05-29 06:55:00,104,69.3,94,63.3,198,66.5,2,0
1523,2019-05-29 07:00:00,102,68.5,91,62.7,193,65.8,2,0
1524,2019-05-29 07:05:00,105,68.0,94,62.2,199,65.3,2,0
1525,2019-05-29 07:10:00,112,67.8,101,62.0,213,65.1,2,0
1526,2019-05-29 07:15:00,117,67.7,105,61.9,222,65.0,2,0
1527,2019-05-29 07:20:00,122,67.7,109,61.9,231,65.0,2,0
1528,2019-05-29 07:25:00,124,67.6,111,61.8,235,64.9,2,0
1529,2019-05-29 07:30:00,126,67.6,114,61.8,240,64.8,2,0
1530,2019-05-29 07:35:00,131,67.4,118,61.6,249,64.7,2,0
1531,2019-05-29 07:40:00,135,67.5,121,61.7,256,64.8,2,0
1532,2019-05-29 07:45:00,136,67.4,122,61.6,258,64.7,2,0
1533,2019-05-29 07:50:00,136,67.4,122,61.6,258,64.7,2,0
1534,2019-05-29 07:55:00,131,67.4,118,61.6,249,64.7,2,0
1535,2019-05-29 08:00:00,126,67.2,113,61.4,239,64.5,2,0
1536,2019-05-29 08:05:00,125,67.1,113,61.3,238,64.3,2,0
1537,2019-05-29 08:10:00,128,66.9,114,61.1,242,64.2,2,0
1538,2019-05-29 08:15:00,129,66.8,115,61.0,244,64.1,2,0
1539,2019-05-29 08:20:00,129,66.7,116,60.9,245,64.0,2,0
1540,2019-05-29 08:25:00,127,66.6,114,60.8,241,63.9,2,0
1541,2019-05-29 08:30:00,125,66.3,113,60.7,238,63.6,2,0
1542,2019-05-29 08:35:00,125,66.1,113,60.5,238,63.4,2,0
1543,2019-05-29 08:40:00,126,66.1,114,60.5,240,63.4,2,0
1544,2019-05-29 08:45:00,126,66.0,114,60.4,240,63.3,2,0
1545,2019-05-29 08:50:00,125,65.9,113,60.3,238,63.2,2,0
1546,2019-05-29 08:55:00,121,65.8,109,60.2,230,63.1,2,0
1547,2019-05-29 09:00:00,117,66.0,106,60.4,223,63.3,2,0
1548,2019-05-29 09:05:00,117,66.0,105,60.4,222,63.4,2,0
1549,2019-05-29 09:10:00,117,66.0,105,60.4,222,63.4,2,0
1550,2019-05-29 09:15:00,119,65.9,106,60.3,225,63.3,2,0
1551,2019-05-29 09:20:00,120,65.9,107,60.3,227,63.3,2,0
1552,2019-05-29 09:25:00,120,65.9,107,60.3,227,63.3,2,0
1553,2019-05-29 09:30:00,119,65.8,106,60.2,225,63.2,2,0
1554,2019-05-29 09:35:00,120,65.9,108,60.3,228,63.2,2,0
1555,2019-05-29 09:40:00,121,65.8,109,60.2,230,63.1,2,0
1556,2019-05-29 09:45:00,122,65.8,109,60.2,231,63.2,2,0
1557,2019-05-29 09:50:00,121,65.9,108,60.3,229,63.3,2,0
1558,2019-05-29 09:55:00,117,65.8,106,60.2,223,63.1,2,0
1559,2019-05-29 10:00:00,115,66.0,103,60.4,218,63.4,2,0
1560,2019-05-29 10:05:00,114,66.0,103,60.4,217,63.3,2,0
1561,2019-05-29 10:10:00,116,66.0,104,60.4,220,63.4,2,0
1562,2019-05-29 10:15:00,117,66.1,105,60.5,222,63.5,2,0
1563,2019-05-29 10:20:00,117,66.2,106,60.6,223,63.5,2,0
1564,2019-05-29 10:25:00,115,66.2,104,60.6,219,63.5,2,0
1565,2019-05-29 10:30:00,117,66.2,105,60.6,222,63.6,2,0
1566,2019-05-29 10:35:00,117,66.3,106,60.7,223,63.6,2,0
1567,2019-05-29 10:40:00,119,66.3,106,60.7,225,63.7,2,0
1568,2019-05-29 10:45:00,120,66.3,107,60.7,227,63.7,2,0
1569,2019-05-29 10:50:00,119,66.3,106,60.7,225,63.7,2,0
1570,2019-05-29 10:55:00,116,66.4,105,60.8,221,63.7,2,0
1571,2019-05-29 11:00:00,114,66.4,102,60.8,216,63.8,2,0
1572,2019-05-29 11:05:00,115,66.3,103,60.7,218,63.7,2,0
1573,2019-05-29 11:10:00,115,66.4,104,60.8,219,63.7,2,0
1574,2019-05-29 11:15:00,115,66.4,104,60.8,219,63.7,2,0
1575,2019-05-29 11:20:00,117,66.4,105,60.8,222,63.8,2,0
1576,2019-05-29 11:25:00,118,66.4,106,60.8,224,63.8,2,0
1577,2019-05-29 11:30:00,117,66.6,106,60.8,223,63.8,2,0
1578,2019-05-29 11:35:00,119,66.6,106,60.8,225,63.9,2,0
1579,2019-05-29 11:40:00,120,66.6,108,60.8,228,63.9,2,0
1580,2019-05-29 11:45:00,121,66.6,109,60.8,230,63.8,2,0
1581,2019-05-29 11:50:00,120,66.6,108,60.8,228,63.9,2,0
1582,2019-05-29 11:55:00,117,66.7,106,60.9,223,63.9,2,0
1583,2019-05-29 12:00:00,118,66.4,106,60.8,224,63.8,2,0
1584,2019-05-29 12:05:00,119,66.3,106,60.7,225,63.7,2,0
1585,2019-05-29 12:10:00,121,66.3,108,60.7,229,63.7,2,0
1586,2019-05-29 12:15:00,123,66.3,110,60.7,233,63.7,2,0
1587,2019-05-29 12:20:00,123,66.4,110,60.8,233,63.8,2,0
1588,2019-05-29 12:25:00,123,66.6,110,60.8,233,63.9,2,0
1589,2019-05-29 12:30:00,122,66.6,109,60.8,231,63.9,2,0
1590,2019-05-29 12:35:00,123,66.7,111,60.9,234,63.9,2,0
1591,2019-05-29 12:40:00,125,66.7,112,60.9,237,64.0,2,0
1592,2019-05-29 12:45:00,125,66.7,113,60.9,238,63.9,2,0
1593,2019-05-29 12:50:00,124,66.8,111,61.0,235,64.1,2,0
1594,2019-05-29 12:55:00,122,66.8,110,61.0,232,64.0,2,0
1595,2019-05-29 13:00:00,121,66.7,109,60.9,230,63.9,2,0
1596,2019-05-29 13:05:00,122,66.7,109,60.9,231,64.0,2,0
1597,2019-05-29 13:10:00,124,66.6,112,60.8,236,63.8,2,0
1598,2019-05-29 13:15:00,126,66.6,113,60.8,239,63.9,2,0
1599,2019-05-29 13:20:00,126,66.6,113,60.8,239,63.9,2,0
1600,2019-05-29 13:25:00,127,66.6,114,60.8,241,63.9,2,0
1601,2019-05-29 13:30:00,126,66.6,113,60.8,239,63.9,2,0
1602,2019-05-29 13:35:00,129,66.6,115,60.8,244,63.9,2,0
1603,2019-05-29 13:40:00,130,66.6,117,60.8,247,63.9,2,0
1604,2019-05-29 13:45:00,130,66.6,117,60.8,247,63.9,2,0
1605,2019-05-29 13:50:00,129,66.6,115,60.8,244,63.9,2,0
1606,2019-05-29 13:55:00,126,66.7,114,60.9,240,63.9,2,0
1607,2019-05-29 14:00:00,130,66.3,116,60.7,246,63.7,2,0
1608,2019-05-29 14:05:00,131,66.3,117,60.7,248,63.7,2,0
1609,2019-05-29 14:10:00,135,66.2,122,60.6,257,63.5,2,0
1610,2019-05-29 14:15:00,139,66.2,124,60.6,263,63.6,2,0
1611,2019-05-29 14:20:00,139,66.1,124,60.5,263,63.5,2,0
1612,2019-05-29 14:25:00,138,66.1,124,60.5,262,63.5,2,0
1613,2019-05-29 14:30:00,140,66.1,125,60.5,265,63.5,2,0
1614,2019-05-29 14:35:00,143,66.1,128,60.5,271,63.5,2,0
1615,2019-05-29 14:40:00,145,66.0,131,60.4,276,63.3,2,0
1616,2019-05-29 14:45:00,145,66.0,131,60.4,276,63.3,2,0
1617,2019-05-29 14:50:00,143,66.0,129,60.4,272,63.3,2,0
1618,2019-05-29 14:55:00,141,66.1,127,60.5,268,63.4,2,0
1619,2019-05-29 15:00:00,138,65.9,124,60.3,262,63.3,2,0
1620,2019-05-29 15:05:00,139,65.8,125,60.2,264,63.1,2,0
1621,2019-05-29 15:10:00,143,65.7,129,60.1,272,63.0,2,0
1622,2019-05-29 15:15:00,143,65.6,129,60.0,272,62.9,2,0
1623,2019-05-29 15:20:00,143,65.6,128,60.0,271,63.0,2,0
1624,2019-05-29 15:25:00,142,65.7,128,60.1,270,63.0,2,0
1625,2019-05-29 15:30:00,142,65.7,127,60.1,269,63.1,2,0
1626,2019-05-29 15:35:00,145,65.7,130,60.1,275,63.1,2,0
1627,2019-05-29 15:40:00,148,65.6,133,60.0,281,63.0,2,0
1628,2019-05-29 15:45:00,148,65.6,133,60.0,281,63.0,2,0
1629,2019-05-29 15:50:00,146,65.7,131,60.1,277,63.1,2,0
1630,2019-05-29 15:55:00,142,65.8,128,60.2,270,63.1,2,0
1631,2019-05-29 16:00:00,141,65.9,126,60.3,267,63.3,2,0
1632,2019-05-29 16:05:00,144,65.9,129,60.3,273,63.3,2,0
1633,2019-05-29 16:10:00,146,65.9,131,60.3,277,63.3,2,0
1634,2019-05-29 16:15:00,148,66.0,132,60.4,280,63.4,2,0
1635,2019-05-29 16:20:00,148,66.0,132,60.4,280,63.4,2,0
1636,2019-05-29 16:25:00,145,66.0,130,60.4,275,63.4,2,0
1637,2019-05-29 16:30:00,144,66.1,129,60.5,273,63.5,2,0
1638,2019-05-29 16:35:00,146,66.2,132,60.6,278,63.5,2,0
1639,2019-05-29 16:40:00,149,66.1,134,60.5,283,63.5,2,0
1640,2019-05-29 16:45:00,150,66.2,134,60.6,284,63.6,2,0
1641,2019-05-29 16:50:00,149,66.2,133,60.6,282,63.6,2,0
1642,2019-05-29 16:55:00,146,66.3,132,60.7,278,63.6,2,0
1643,2019-05-29 17:00:00,145,66.3,130,60.7,275,63.7,2,0
1644,2019-05-29 17:05:00,148,66.3,133,60.7,281,63.7,2,0
1645,2019-05-29 17:10:00,151,66.3,136,60.7,287,63.6,2,0
1646,2019-05-29 17:15:00,152,66.2,137,60.6,289,63.5,2,0
1647,2019-05-29 17:20:00,151,66.3,135,60.7,286,63.7,2,0
1648,2019-05-29 17:25:00,149,66.3,133,60.7,282,63.7,2,0
1649,2019-05-29 17:30:00,146,66.4,132,60.8,278,63.7,2,0
1650,2019-05-29 17:35:00,145,66.6,130,60.8,275,63.9,2,0
1651,2019-05-29 17:40:00,145,66.8,130,61.0,275,64.1,2,0
1652,2019-05-29 17:45:00,145,66.9,130,61.1,275,64.2,2,0
1653,2019-05-29 17:50:00,142,67.0,128,61.2,270,64.2,2,0
1654,2019-05-29 17:55:00,139,67.1,125,61.3,264,64.4,2,0
1655,2019-05-29 18:00:00,137,67.3,123,61.5,260,64.6,2,0
1656,2019-05-29 18:05:00,136,67.5,123,61.7,259,64.7,2,0
1657,2019-05-29 18:10:00,138,67.6,123,61.8,261,64.9,2,0
1658,2019-05-29 18:15:00,138,67.7,123,61.9,261,65.0,2,0
1659,2019-05-29 18:20:00,136,67.8,123,62.0,259,65.0,2,0
1660,2019-05-29 18:25:00,134,68.0,120,62.2,254,65.3,2,0
1661,2019-05-29 18:30:00,132,68.3,118,62.5,250,65.6,2,0
1662,2019-05-29 18:35:00,130,68.4,116,62.6,246,65.7,2,0
1663,2019-05-29 18:40:00,130,68.6,116,62.8,246,65.9,2,0
1664,2019-05-29 18:45:00,126,68.7,114,62.9,240,65.9,2,0
1665,2019-05-29 18:50:00,124,68.9,112,62.9,236,66.1,2,0
1666,2019-05-29 18:55:00,121,69.0,109,63.0,230,66.2,2,0
1667,2019-05-29 19:00:00,119,69.4,106,63.4,225,66.6,2,0
1668,2019-05-29 19:05:00,117,69.6,106,63.6,223,66.7,2,0
1669,2019-05-29 19:10:00,117,69.7,106,63.7,223,66.8,2,0
1670,2019-05-29 19:15:00,116,69.8,104,63.8,220,67.0,2,0
1671,2019-05-29 19:20:00,115,69.9,104,63.9,219,67.1,2,0
1672,2019-05-29 19:25:00,111,70.0,100,64.0,211,67.2,2,0
1673,2019-05-29 19:30:00,107,70.1,97,64.1,204,67.2,2,0
1674,2019-05-29 19:35:00,106,70.1,95,64.1,201,67.3,2,0
1675,2019-05-29 19:40:00,103,70.2,93,64.2,196,67.4,2,0
1676,2019-05-29 19:45:00,102,70.2,91,64.2,193,67.4,2,0
1677,2019-05-29 19:50:00,100,70.2,90,64.2,190,67.4,2,0
1678,2019-05-29 19:55:00,97,70.2,87,64.2,184,67.4,2,0
1679,2019-05-29 20:00:00,95,70.4,85,64.4,180,67.6,2,0
1680,2019-05-29 20:05:00,94,70.5,84,64.5,178,67.7,2,0
1681,2019-05-29 20:10:00,93,70.5,84,64.5,177,67.7,2,0
1682,2019-05-29 20:15:00,93,70.4,84,64.4,177,67.6,2,0
1683,2019-05-29 20:20:00,91,70.5,82,64.5,173,67.7,2,0
1684,2019-05-29 20:25:00,90,70.5,80,64.5,170,67.7,2,0
1685,2019-05-29 20:30:00,87,70.4,79,64.4,166,67.5,2,0
1686,2019-05-29 20:35:00,86,70.4,77,64.4,163,67.6,2,0
1687,2019-05-29 20:40:00,85,70.4,77,64.4,162,67.5,2,0
1688,2019-05-29 20:45:00,84,70.2,76,64.2,160,67.4,2,0
1689,2019-05-29 20:50:00,83,70.1,74,64.1,157,67.3,2,0
1690,2019-05-29 20:55:00,82,70.0,73,64.0,155,67.2,2,0
1691,2019-05-29 21:00:00,81,70.3,73,64.3,154,67.5,2,0
1692,2019-05-29 21:05:00,80,70.4,72,64.4,152,67.6,2,0
1693,2019-05-29 21:10:00,82,70.4,73,64.4,155,67.6,2,0
1694,2019-05-29 21:15:00,81,70.4,73,64.4,154,67.6,2,0
1695,2019-05-29 21:20:00,80,70.4,71,64.4,151,67.6,2,0
1696,2019-05-29 21:25:00,77,70.5,70,64.5,147,67.6,2,0
1697,2019-05-29 21:30:00,75,70.5,68,64.5,143,67.6,2,0
1698,2019-05-29 21:35:00,74,70.6,66,64.6,140,67.8,2,0
1699,2019-05-29 21:40:00,72,70.7,65,64.7,137,67.9,2,0
1700,2019-05-29 21:45:00,70,70.7,63,64.7,133,67.9,2,0
1701,2019-05-29 21:50:00,68,70.8,61,64.8,129,68.0,2,0
1702,2019-05-29 21:55:00,65,70.8,58,64.8,123,68.0,2,0
1703,2019-05-29 22:00:00,63,70.8,56,64.8,119,68.0,2,0
1704,2019-05-29 22:05:00,63,70.8,56,64.8,119,68.0,2,0
1705,2019-05-29 22:10:00,62,70.8,56,64.8,118,68.0,2,0
1706,2019-05-29 22:15:00,61,70.8,54,64.8,115,68.0,2,0
1707,2019-05-29 22:20:00,58,70.8,53,64.8,111,67.9,2,0
1708,2019-05-29 22:25:00,56,70.8,51,64.8,107,67.9,2,0
1709,2019-05-29 22:30:00,54,70.8,48,64.8,102,68.0,2,0
1710,2019-05-29 22:35:00,52,70.8,47,64.8,99,68.0,2,0
1711,2019-05-29 22:40:00,51,70.8,45,64.8,96,68.0,2,0
1712,2019-05-29 22:45:00,49,70.8,44,64.8,93,68.0,2,0
1713,2019-05-29 22:50:00,46,70.8,42,64.8,88,67.9,2,0
1714,2019-05-29 22:55:00,44,70.8,39,64.8,83,68.0,2,0
1715,2019-05-29 23:00:00,41,70.7,37,64.7,78,67.9,2,0
1716,2019-05-29 23:05:00,41,70.8,36,64.8,77,68.0,2,0
1717,2019-05-29 23:10:00,40,70.8,36,64.8,76,68.0,2,0
1718,2019-05-29 23:15:00,38,70.7,35,64.7,73,67.8,2,0
1719,2019-05-29 23:20:00,37,70.7,33,64.7,70,67.9,2,0
1720,2019-05-29 23:25:00,34,70.7,31,64.7,65,67.8,2,0
1721,2019-05-29 23:30:00,33,70.7,29,64.7,62,67.9,2,0
1722,2019-05-29 23:35:00,33,70.7,29,64.7,62,67.9,2,0
1723,2019-05-29 23:40:00,32,70.7,29,64.7,61,67.8,2,0
1724,2019-05-29 23:45:00,31,70.7,27,64.7,58,67.9,2,0
1725,2019-05-29 23:50:00,28,70.7,26,64.7,54,67.8,2,0
1726,2019-05-29 23:55:00,26,70.7,24,64.7,50,67.8,2,0
1727,2019-05-30 00:00:00,25,71.2,23,65.0,48,68.2,2,0
1728,2019-05-30 00:05:00,25,71.0,22,65.0,47,68.2,2,0
1729,2019-05-30 00:10:00,24,70.9,22,64.9,46,68.0,2,0
1730,2019-05-30 00:15:00,22,70.8,20,64.8,42,67.9,2,0
1731,2019-05-30 00:20:00,21,70.8,19,64.8,40,68.0,2,0
1732,2019-05-30 00:25:00,19,70.8,18,64.8,37,67.9,2,0
1733,2019-05-30 00:30:00,18,70.7,16,64.7,34,67.9,2,0
1734,2019-05-30 00:35:00,17,70.7,16,64.7,33,67.8,2,0
1735,2019-05-30 00:40:00,16,70.6,15,64.6,31,67.7,2,0
1736,2019-05-30 00:45:00,15,70.6,14,64.6,29,67.7,2,0
1737,2019-05-30 00:50:00,14,70.5,13,64.5,27,67.6,2,0
1738,2019-05-30 00:55:00,14,70.6,12,64.6,26,67.8,2,0
1739,2019-05-30 01:00:00,13,70.6,11,64.6,24,67.9,2,0
1740,2019-05-30 01:05:00,12,70.7,11,64.7,23,67.8,2,0
1741,2019-05-30 01:10:00,12,70.7,10,64.7,22,68.0,2,0
1742,2019-05-30 01:15:00,12,70.6,10,64.6,22,67.9,2,0
1743,2019-05-30 01:20:00,11,70.6,10,64.6,21,67.7,2,0
1744,2019-05-30 01:25:00,10,70.6,9,64.6,19,67.8,2,0
1745,2019-05-30 01:30:00,10,70.6,9,64.6,19,67.8,2,0
1746,2019-05-30 01:35:00,10,70.5,9,64.5,19,67.7,2,0
1747,2019-05-30 01:40:00,10,70.5,9,64.5,19,67.7,2,0
1748,2019-05-30 01:45:00,9,70.5,9,64.5,18,67.5,2,0
1749,2019-05-30 01:50:00,9,70.5,8,64.5,17,67.7,2,0
1750,2019-05-30 01:55:00,9,70.4,8,64.4,17,67.6,2,0
1751,2019-05-30 02:00:00,8,70.5,8,64.5,16,67.5,2,0
1752,2019-05-30 02:05:00,8,70.5,8,64.5,16,67.5,2,0
1753,2019-05-30 02:10:00,8,70.5,8,64.5,16,67.5,2,0
1754,2019-05-30 02:15:00,8,70.5,8,64.5,16,67.5,2,0
1755,2019-05-30 02:20:00,8,70.5,8,64.5,16,67.5,2,0
1756,2019-05-30 02:25:00,8,70.5,8,64.5,16,67.5,2,0
1757,2019-05-30 02:30:00,8,70.5,8,64.5,16,67.5,2,0
1758,2019-05-30 02:35:00,8,70.5,8,64.5,16,67.5,2,0
1759,2019-05-30 02:40:00,8,70.5,8,64.5,16,67.5,2,0
1760,2019-05-30 02:45:00,8,70.5,8,64.5,16,67.5,2,0
1761,2019-05-30 02:50:00,8,70.4,8,64.4,16,67.4,2,0
1762,2019-05-30 02:55:00,8,70.4,7,64.4,15,67.6,2,0
1763,2019-05-30 03:00:00,8,70.4,7,64.4,15,67.6,2,0
1764,2019-05-30 03:05:00,8,70.4,7,64.4,15,67.6,2,0
1765,2019-05-30 03:10:00,8,70.4,7,64.4,15,67.6,2,0
1766,2019-05-30 03:15:00,8,70.4,8,64.4,16,67.4,2,0
1767,2019-05-30 03:20:00,9,70.4,8,64.4,17,67.6,2,0
1768,2019-05-30 03:25:00,9,70.4,8,64.4,17,67.6,2,0
1769,2019-05-30 03:30:00,10,70.4,9,64.4,19,67.6,2,0
1770,2019-05-30 03:35:00,11,70.4,10,64.4,21,67.5,2,0
1771,2019-05-30 03:40:00,12,70.5,11,64.5,23,67.6,2,0
1772,2019-05-30 03:45:00,13,70.6,11,64.6,24,67.9,2,0
1773,2019-05-30 03:50:00,13,70.6,12,64.6,25,67.7,2,0
1774,2019-05-30 03:55:00,13,70.5,12,64.5,25,67.6,2,0
1775,2019-05-30 04:00:00,13,70.4,12,64.4,25,67.5,2,0
1776,2019-05-30 04:05:00,14,70.4,12,64.4,26,67.6,2,0
1777,2019-05-30 04:10:00,15,70.4,14,64.4,29,67.5,2,0
1778,2019-05-30 04:15:00,17,70.4,16,64.4,33,67.5,2,0
1779,2019-05-30 04:20:00,19,70.4,17,64.4,36,67.6,2,0
1780,2019-05-30 04:25:00,20,70.5,18,64.5,38,67.7,2,0
1781,2019-05-30 04:30:00,22,70.6,20,64.6,42,67.7,2,0
1782,2019-05-30 04:35:00,25,70.7,23,64.7,48,67.8,2,0
1783,2019-05-30 04:40:00,28,70.8,26,64.8,54,67.9,2,0
1784,2019-05-30 04:45:00,31,70.8,27,64.8,58,68.0,2,0
1785,2019-05-30 04:50:00,33,70.9,29,64.9,62,68.1,2,0
1786,2019-05-30 04:55:00,33,70.9,29,64.9,62,68.1,2,0
1787,2019-05-30 05:00:00,34,70.7,31,64.7,65,67.8,2,0
1788,2019-05-30 05:05:00,36,70.7,33,64.7,69,67.8,2,0
1789,2019-05-30 05:10:00,41,70.7,36,64.7,77,67.9,2,0
1790,2019-05-30 05:15:00,44,70.7,40,64.7,84,67.8,2,0
1791,2019-05-30 05:20:00,48,70.7,44,64.7,92,67.8,2,0
1792,2019-05-30 05:25:00,51,70.6,46,64.6,97,67.8,2,0
1793,2019-05-30 05:30:00,55,70.7,50,64.7,105,67.8,2,0
1794,2019-05-30 05:35:00,59,70.7,53,64.7,112,67.9,2,0
1795,2019-05-30 05:40:00,64,70.8,57,64.8,121,68.0,2,0
1796,2019-05-30 05:45:00,67,70.8,60,64.8,127,68.0,2,0
1797,2019-05-30 05:50:00,68,70.9,62,64.9,130,68.0,2,0
1798,2019-05-30 05:55:00,67,70.9,61,64.9,128,68.0,2,0
1799,2019-05-30 06:00:00,66,69.9,60,63.9,126,67.0,2,0
1800,2019-05-30 06:05:00,70,69.4,63,63.4,133,66.6,2,0
1801,2019-05-30 06:10:00,76,69.2,68,63.2,144,66.4,2,0
1802,2019-05-30 06:15:00,81,69.2,73,63.2,154,66.4,2,0
1803,2019-05-30 06:20:00,85,69.1,76,63.1,161,66.3,2,0
1804,2019-05-30 06:25:00,89,69.0,79,63.0,168,66.2,2,0
1805,2019-05-30 06:30:00,93,69.0,83,63.0,176,66.2,2,0
1806,2019-05-30 06:35:00,99,69.1,88,63.1,187,66.3,2,0
1807,2019-05-30 06:40:00,104,69.1,93,63.1,197,66.3,2,0
1808,2019-05-30 06:45:00,107,69.2,97,63.2,204,66.3,2,0
1809,2019-05-30 06:50:00,107,69.3,96,63.3,203,66.5,2,0
1810,2019-05-30 06:55:00,104,69.3,94,63.3,198,66.5,2,0
1811,2019-05-30 07:00:00,103,68.5,92,62.7,195,65.8,2,0
1812,2019-05-30 07:05:00,105,68.0,95,62.2,200,65.2,2,0
1813,2019-05-30 07:10:00,112,67.8,101,62.0,213,65.1,2,0
1814,2019-05-30 07:15:00,117,67.7,106,61.9,223,64.9,2,0
1815,2019-05-30 07:20:00,122,67.7,109,61.9,231,65.0,2,0
1816,2019-05-30 07:25:00,125,67.6,112,61.8,237,64.9,2,0
1817,2019-05-30 07:30:00,127,67.5,114,61.7,241,64.8,2,0
1818,2019-05-30 07:35:00,131,67.4,118,61.6,249,64.7,2,0
1819,2019-05-30 07:40:00,134,67.5,121,61.7,255,64.7,2,0
1820,2019-05-30 07:45:00,136,67.4,122,61.6,258,64.7,2,0
1821,2019-05-30 07:50:00,134,67.4,121,61.6,255,64.6,2,0
1822,2019-05-30 07:55:00,131,67.3,118,61.5,249,64.6,2,0
1823,2019-05-30 08:00:00,128,67.2,114,61.4,242,64.5,2,0
1824,2019-05-30 08:05:00,126,67.1,113,61.3,239,64.4,2,0
1825,2019-05-30 08:10:00,128,66.8,114,61.0,242,64.1,2,0
1826,2019-05-30 08:15:00,131,66.7,117,60.9,248,64.0,2,0
1827,2019-05-30 08:20:00,130,66.6,117,60.8,247,63.9,2,0
1828,2019-05-30 08:25:00,128,66.4,115,60.8,243,63.8,2,0
1829,2019-05-30 08:30:00,125,66.1,113,60.5,238,63.4,2,0
1830,2019-05-30 08:35:00,126,66.0,113,60.4,239,63.4,2,0
1831,2019-05-30 08:40:00,128,65.9,114,60.3,242,63.3,2,0
1832,2019-05-30 08:45:00,128,65.8,115,60.2,243,63.2,2,0
1833,2019-05-30 08:50:00,126,65.8,113,60.2,239,63.2,2,0
1834,2019-05-30 08:55:00,123,65.7,110,60.1,233,63.1,2,0
1835,2019-05-30 09:00:00,119,66.0,107,60.4,226,63.4,2,0
1836,2019-05-30 09:05:00,117,65.9,106,60.3,223,63.2,2,0
1837,2019-05-30 09:10:00,119,65.8,106,60.2,225,63.2,2,0
1838,2019-05-30 09:15:00,120,65.7,107,60.1,227,63.1,2,0
1839,2019-05-30 09:20:00,121,65.7,108,60.1,229,63.1,2,0
1840,2019-05-30 09:25:00,121,65.7,109,60.1,230,63.0,2,0
1841,2019-05-30 09:30:00,120,65.7,108,60.1,228,63.0,2,0
1842,2019-05-30 09:35:00,122,65.7,109,60.1,231,63.1,2,0
1843,2019-05-30 09:40:00,123,65.8,111,60.2,234,63.1,2,0
1844,2019-05-30 09:45:00,124,65.9,112,60.3,236,63.2,2,0
1845,2019-05-30 09:50:00,123,65.8,110,60.2,233,63.2,2,0
1846,2019-05-30 09:55:00,120,65.8,108,60.2,228,63.1,2,0
1847,2019-05-30 10:00:00,116,65.9,105,60.3,221,63.2,2,0
1848,2019-05-30 10:05:00,116,65.9,105,60.3,221,63.2,2,0
1849,2019-05-30 10:10:00,118,65.9,106,60.3,224,63.3,2,0
1850,2019-05-30 10:15:00,119,65.9,107,60.3,226,63.3,2,0
1851,2019-05-30 10:20:00,119,65.9,107,60.3,226,63.3,2,0
1852,2019-05-30 10:25:00,119,66.0,106,60.4,225,63.4,2,0
1853,2019-05-30 10:30:00,120,66.0,107,60.4,227,63.4,2,0
1854,2019-05-30 10:35:00,120,66.1,107,60.5,227,63.5,2,0
1855,2019-05-30 10:40:00,122,66.1,110,60.5,232,63.4,2,0
1856,2019-05-30 10:45:00,122,66.2,110,60.6,232,63.5,2,0
1857,2019-05-30 10:50:00,121,66.2,108,60.6,229,63.6,2,0
1858,2019-05-30 10:55:00,118,66.1,106,60.5,224,63.5,2,0
1859,2019-05-30 11:00:00,117,66.2,105,60.6,222,63.6,2,0
1860,2019-05-30 11:05:00,117,66.2,105,60.6,222,63.6,2,0
1861,2019-05-30 11:10:00,118,66.2,106,60.6,224,63.6,2,0
1862,2019-05-30 11:15:00,120,66.2,108,60.6,228,63.5,2,0
1863,2019-05-30 11:20:00,121,66.2,108,60.6,229,63.6,2,0
1864,2019-05-30 11:25:00,121,66.2,108,60.6,229,63.6,2,0
1865,2019-05-30 11:30:00,121,66.3,109,60.7,230,63.6,2,0
1866,2019-05-30 11:35:00,122,66.3,109,60.7,231,63.7,2,0
1867,2019-05-30 11:40:00,124,66.3,111,60.7,235,63.7,2,0
1868,2019-05-30 11:45:00,124,66.4,111,60.8,235,63.8,2,0
1869,2019-05-30 11:50:00,123,66.4,111,60.8,234,63.7,2,0
1870,2019-05-30 11:55:00,121,66.6,109,60.8,230,63.8,2,0
1871,2019-05-30 12:00:00,120,66.4,108,60.8,228,63.7,2,0
1872,2019-05-30 12:05:00,122,66.3,109,60.7,231,63.7,2,0
1873,2019-05-30 12:10:00,124,66.4,111,60.8,235,63.8,2,0
1874,2019-05-30 12:15:00,125,66.4,113,60.8,238,63.7,2,0
1875,2019-05-30 12:20:00,125,66.4,112,60.8,237,63.8,2,0
1876,2019-05-30 12:25:00,125,66.4,112,60.8,237,63.8,2,0
1877,2019-05-30 12:30:00,124,66.4,111,60.8,235,63.8,2,0
1878,2019-05-30 12:35:00,125,66.6,113,60.8,238,63.8,2,0
1879,2019-05-30 12:40:00,125,66.6,113,60.8,238,63.8,2,0
1880,2019-05-30 12:45:00,127,66.6,114,60.8,241,63.9,2,0
1881,2019-05-30 12:50:00,126,66.7,114,60.9,240,63.9,2,0
1882,2019-05-30 12:55:00,124,66.7,112,60.9,236,63.9,2,0
1883,2019-05-30 13:00:00,122,66.6,109,60.8,231,63.9,2,0
1884,2019-05-30 13:05:00,123,66.4,111,60.8,234,63.7,2,0
1885,2019-05-30 13:10:00,126,66.3,114,60.7,240,63.6,2,0
1886,2019-05-30 13:15:00,129,66.3,115,60.7,244,63.7,2,0
1887,2019-05-30 13:20:00,129,66.3,116,60.7,245,63.7,2,0
1888,2019-05-30 13:25:00,129,66.4,116,60.8,245,63.8,2,0
1889,2019-05-30 13:30:00,129,66.6,115,60.8,244,63.9,2,0
1890,2019-05-30 13:35:00,131,66.4,117,60.8,248,63.8,2,0
1891,2019-05-30 13:40:00,132,66.4,119,60.8,251,63.7,2,0
1892,2019-05-30 13:45:00,132,66.4,118,60.8,250,63.8,2,0
1893,2019-05-30 13:50:00,132,66.3,118,60.7,250,63.7,2,0
1894,2019-05-30 13:55:00,132,66.4,118,60.8,250,63.8,2,0
1895,2019-05-30 14:00:00,131,66.2,118,60.6,249,63.5,2,0
1896,2019-05-30 14:05:00,132,66.1,119,60.5,251,63.4,2,0
1897,2019-05-30 14:10:00,138,66.0,123,60.4,261,63.4,2,0
1898,2019-05-30 14:15:00,141,65.9,127,60.3,268,63.2,2,0
1899,2019-05-30 14:20:00,142,65.9,127,60.3,269,63.3,2,0
1900,2019-05-30 14:25:00,142,65.9,127,60.3,269,63.3,2,0
1901,2019-05-30 14:30:00,142,65.9,128,60.3,270,63.2,2,0
1902,2019-05-30 14:35:00,146,65.8,131,60.2,277,63.2,2,0
1903,2019-05-30 14:40:00,149,65.8,133,60.2,282,63.2,2,0
1904,2019-05-30 14:45:00,150,65.7,134,60.1,284,63.1,2,0
1905,2019-05-30 14:50:00,146,65.7,132,60.1,278,63.0,2,0
1906,2019-05-30 14:55:00,143,65.8,128,60.2,271,63.2,2,0
1907,2019-05-30 15:00:00,142,65.8,127,60.2,269,63.2,2,0
1908,2019-05-30 15:05:00,141,65.7,127,60.1,268,63.0,2,0
1909,2019-05-30 15:10:00,144,65.5,130,59.9,274,62.8,2,0
1910,2019-05-30 15:15:00,145,65.6,131,60.0,276,62.9,2,0
1911,2019-05-30 15:20:00,145,65.6,130,60.0,275,63.0,2,0
1912,2019-05-30 15:25:00,143,65.6,129,60.0,272,62.9,2,0
1913,2019-05-30 15:30:00,143,65.6,128,60.0,271,63.0,2,0
1914,2019-05-30 15:35:00,145,65.5,130,59.9,275,62.9,2,0
1915,2019-05-30 15:40:00,148,65.5,133,59.9,281,62.8,2,0
1916,2019-05-30 15:45:00,148,65.5,133,59.9,281,62.8,2,0
1917,2019-05-30 15:50:00,145,65.6,131,60.0,276,62.9,2,0
1918,2019-05-30 15:55:00,143,65.7,129,60.1,272,63.0,2,0
1919,2019-05-30 16:00:00,143,65.7,128,60.1,271,63.1,2,0
1920,2019-05-30 16:05:00,144,65.8,129,60.2,273,63.2,2,0
1921,2019-05-30 16:10:00,148,65.8,132,60.2,280,63.2,2,0
1922,2019-05-30 16:15:00,148,65.7,133,60.1,281,63.1,2,0
1923,2019-05-30 16:20:00,146,65.8,131,60.2,277,63.2,2,0
1924,2019-05-30 16:25:00,145,65.9,131,60.3,276,63.2,2,0
1925,2019-05-30 16:30:00,144,66.0,130,60.4,274,63.3,2,0
1926,2019-05-30 16:35:00,147,65.9,132,60.3,279,63.3,2,0
1927,2019-05-30 16:40:00,151,65.9,135,60.3,286,63.3,2,0
1928,2019-05-30 16:45:00,151,65.9,135,60.3,286,63.3,2,0
1929,2019-05-30 16:50:00,149,65.9,133,60.3,282,63.3,2,0
1930,2019-05-30 16:55:00,146,66.0,132,60.4,278,63.3,2,0
1931,2019-05-30 17:00:00,145,66.1,131,60.5,276,63.4,2,0
1932,2019-05-30 17:05:00,148,66.2,132,60.6,280,63.6,2,0
1933,2019-05-30 17:10:00,152,66.1,136,60.5,288,63.5,2,0
1934,2019-05-30 17:15:00,153,66.0,137,60.4,290,63.4,2,0
1935,2019-05-30 17:20:00,150,66.0,135,60.4,285,63.3,2,0
1936,2019-05-30 17:25:00,148,66.1,132,60.5,280,63.5,2,0
1937,2019-05-30 17:30:00,146,66.2,131,60.6,277,63.6,2,0
1938,2019-05-30 17:35:00,145,66.2,130,60.6,275,63.6,2,0
1939,2019-05-30 17:40:00,144,66.2,130,60.6,274,63.5,2,0
1940,2019-05-30 17:45:00,143,66.3,129,60.7,272,63.6,2,0
1941,2019-05-30 17:50:00,141,66.4,127,60.8,268,63.7,2,0
1942,2019-05-30 17:55:00,139,66.7,125,60.9,264,64.0,2,0
1943,2019-05-30 18:00:00,136,66.9,123,61.1,259,64.1,2,0
1944,2019-05-30 18:05:00,137,67.0,123,61.2,260,64.3,2,0
1945,2019-05-30 18:10:00,138,67.2,124,61.4,262,64.5,2,0
1946,2019-05-30 18:15:00,138,67.2,123,61.4,261,64.5,2,0
1947,2019-05-30 18:20:00,136,67.4,123,61.6,259,64.6,2,0
1948,2019-05-30 18:25:00,134,67.5,121,61.7,255,64.7,2,0
1949,2019-05-30 18:30:00,132,67.8,118,62.0,250,65.1,2,0
1950,2019-05-30 18:35:00,130,67.9,117,62.1,247,65.2,2,0
1951,2019-05-30 18:40:00,130,68.0,117,62.2,247,65.3,2,0
1952,2019-05-30 18:45:00,129,68.1,115,62.3,244,65.4,2,0
1953,2019-05-30 18:50:00,126,68.3,113,62.5,239,65.6,2,0
1954,2019-05-30 18:55:00,123,68.4,111,62.6,234,65.7,2,0
1955,2019-05-30 19:00:00,122,68.9,110,62.9,232,66.1,2,0
1956,2019-05-30 19:05:00,121,69.0,108,63.0,229,66.2,2,0
1957,2019-05-30 19:10:00,121,69.2,108,63.2,229,66.4,2,0
1958,2019-05-30 19:15:00,120,69.3,107,63.3,227,66.5,2,0
1959,2019-05-30 19:20:00,118,69.4,106,63.4,224,66.6,2,0
1960,2019-05-30 19:25:00,115,69.5,104,63.5,219,66.6,2,0
1961,2019-05-30 19:30:00,112,69.6,100,63.6,212,66.8,2,0
1962,2019-05-30 19:35:00,110,69.7,99,63.7,209,66.9,2,0
1963,2019-05-30 19:40:00,110,69.8,99,63.8,209,67.0,2,0
1964,2019-05-30 19:45:00,106,69.9,96,63.9,202,67.0,2,0
1965,2019-05-30 19:50:00,104,70.0,93,64.0,197,67.2,2,0
1966,2019-05-30 19:55:00,102,70.0,92,64.0,194,67.2,2,0
1967,2019-05-30 20:00:00,100,70.2,89,64.2,189,67.4,2,0
1968,2019-05-30 20:05:00,97,70.3,88,64.3,185,67.4,2,0
1969,2019-05-30 20:10:00,99,70.4,88,64.4,187,67.6,2,0
1970,2019-05-30 20:15:00,97,70.4,88,64.4,185,67.5,2,0
1971,2019-05-30 20:20:00,96,70.3,87,64.3,183,67.4,2,0
1972,2019-05-30 20:25:00,94,70.3,84,64.3,178,67.5,2,0
1973,2019-05-30 20:30:00,91,70.3,82,64.3,173,67.5,2,0
1974,2019-05-30 20:35:00,90,70.2,80,64.2,170,67.4,2,0
1975,2019-05-30 20:40:00,89,70.1,79,64.1,168,67.3,2,0
1976,2019-05-30 20:45:00,88,70.0,79,64.0,167,67.2,2,0
1977,2019-05-30 20:50:00,86,70.0,77,64.0,163,67.2,2,0
1978,2019-05-30 20:55:00,85,69.9,76,63.9,161,67.1,2,0
1979,2019-05-30 21:00:00,83,70.2,75,64.2,158,67.4,2,0
1980,2019-05-30 21:05:00,83,70.2,75,64.2,158,67.4,2,0
1981,2019-05-30 21:10:00,83,70.3,75,64.3,158,67.5,2,0
1982,2019-05-30 21:15:00,84,70.3,75,64.3,159,67.5,2,0
1983,2019-05-30 21:20:00,82,70.3,74,64.3,156,67.5,2,0
1984,2019-05-30 21:25:00,81,70.4,72,64.4,153,67.6,2,0
1985,2019-05-30 21:30:00,79,70.4,71,64.4,150,67.6,2,0
1986,2019-05-30 21:35:00,77,70.5,70,64.5,147,67.6,2,0
1987,2019-05-30 21:40:00,76,70.5,68,64.5,144,67.7,2,0
1988,2019-05-30 21:45:00,74,70.6,67,64.6,141,67.8,2,0
1989,2019-05-30 21:50:00,72,70.6,64,64.6,136,67.8,2,0
1990,2019-05-30 21:55:00,68,70.7,62,64.7,130,67.8,2,0
1991,2019-05-30 22:00:00,66,70.7,60,64.7,126,67.8,2,0
1992,2019-05-30 22:05:00,65,70.7,58,64.7,123,67.9,2,0
1993,2019-05-30 22:10:00,65,70.7,59,64.7,124,67.8,2,0
1994,2019-05-30 22:15:00,64,70.7,58,64.7,122,67.8,2,0
1995,2019-05-30 22:20:00,63,70.8,56,64.8,119,68.0,2,0
1996,2019-05-30 22:25:00,60,70.8,54,64.8,114,68.0,2,0
1997,2019-05-30 22:30:00,58,70.8,52,64.8,110,68.0,2,0
1998,2019-05-30 22:35:00,56,70.8,50,64.8,106,68.0,2,0
1999,2019-05-30 22:40:00,55,70.9,49,64.9,104,68.1,2,0
2000,2019-05-30 22:45:00,53,70.9,47,64.9,100,68.1,2,0
2001,2019-05-30 22:50:00,50,70.9,45,64.9,95,68.1,2,0
2002,2019-05-30 22:55:00,47,70.9,43,64.9,90,68.0,2,0
2003,2019-05-30 23:00:00,45,70.8,41,64.8,86,67.9,2,0
2004,2019-05-30 23:05:00,44,70.8,40,64.8,84,67.9,2,0
2005,2019-05-30 23:10:00,44,70.8,40,64.8,84,67.9,2,0
2006,2019-05-30 23:15:00,42,70.8,38,64.8,80,68.0,2,0
2007,2019-05-30 23:20:00,40,70.7,36,64.7,76,67.9,2,0
2008,2019-05-30 23:25:00,38,70.7,34,64.7,72,67.9,2,0
2009,2019-05-30 23:30:00,36,70.7,33,64.7,69,67.8,2,0
2010,2019-05-30 23:35:00,36,70.7,32,64.7,68,67.9,2,0
2011,2019-05-30 23:40:00,35,70.7,31,64.7,66,67.9,2,0
2012,2019-05-30 23:45:00,33,70.7,30,64.7,63,67.8,2,0
2013,2019-05-30 23:50:00,32,70.7,28,64.7,60,67.9,2,0
2014,2019-05-30 23:55:00,30,70.7,26,64.7,56,67.9,2,0
